Арианне Хартоно=Хартоно А.,Хартоно Арианне
Ирина Фетекау=Фетекау И.,Фетекау Ирина
Мисаки Мацуда=Мацуда М.,Мацуда Мисаки
Риса Усидзима=Усидзима Р.,Усидзима Риса
Обан Дроге=Дроге О.,Дроге Обан
Надия Подороска=Подороска Н.,Подороска Надия
Паула Каня=Каня П.,Каня Паула
Есинь Ма=Ма Е.,Ма Есинь
Тереза Михаликова=Михаликова Т.,Михаликова Тереза
Маргарита Лазарева=Лазарева М.,Лазарева Маргарита
Дарья Касаткина=Касаткина Д.,Касаткина Дарья
Айша Мухаммад=Мухаммад А.,Мухаммад Айша
Эмилиана Аранго=Аранго Э.,Аранго Эмилиана
Саназ Маранд=Маранд С.,Маранд Саназ
Кэролайн Доулхайд=Доулхайд К.,Доулхайд Кэролайн
Даша Иванова=Иванова Д.,Иванова Даша
Катарина Кужмова=Кужмова К.,Кужмова Катарина
Алина Силич=Силич А.,Силич Алина
Ольга Хелми=Хелми О.,Хелми Ольга
Арабелла Коллер=Коллер А.,Коллер Арабелла
Киока Окамура=Окамура К.,Окамура Киока
Радка Зельницкова=Зельницкова Р.,Зельницкова Радка
Эбби Майерс=Майерс Э.,Майерс Эбби
Виктория Азаренко=Азаренко В.,Азаренко Виктория
Анастасия Куликова=Куликова А.,Куликова Анастасия
Майя Лумсден=Лумсден М.,Лумсден Майя
Кэти Макнелли=Макнелли К.,Макнелли Кэти
Наталья Вихлянцева=Вихлянцева Н.,Вихлянцева Наталья
Селия Сервино Руис=Сервино Руис С.,Сервино Руис Селия
Тамара Зиданшек=Зиданшек Т.,Зиданшек Тамара
Барбара Гатика=Гатика Б.,Гатика Барбара
Марина Заневская=Заневская М.,Заневская Марина
Изабелла Шиникова=Шиникова И.,Шиникова Изабелла
Николь Меликар=Меликар Н.,Меликар Николь
Эстрелья Кабеса-Кандела=Кабеса-Кандела Э.,Кабеса-Кандела Эстрелья
Мариам Болквадзе=Болквадзе М.,Болквадзе Мариам
Чан Лю=Лю Ч.,Лю Чан
Зил Десаи=Десаи З.,Десаи Зил
Кайя Канепи=Канепи К.,Канепи Кайя
Маркета Вондроушова=Вондроушова М.,Вондроушова Маркета
Илона Кремень=Кремень И.,Кремень Илона
Шуюэ Ма=Ма Ш.,Ма Шуюэ
Чжэн Сайсай=Сайсай Ч.,Сайсай Чжэн
Элени Кордолаими=Кордолаими Э.,Кордолаими Элени
Никола Бартункова=Бартункова Н.,Бартункова Никола
Совджанья Бависетти=Бависетти С.,Бависетти Совджанья
Кори Гауфф=Гауфф К.,Гауфф Кори
Виктория Дювал=Дювал В.,Дювал Виктория
Джулия Гатто-Монтиконе=Гатто-Монтиконе Д.,Гатто-Монтиконе Джулия
Сюзан Бандеччи=Бандеччи С.,Бандеччи Сюзан
Ева Лис=Лис Е.,Лис Ева
Сюй Шилинь=Шилинь С.,Шилинь Сюй
Джорджия Маркетти=Маркетти Д.,Маркетти Джорджия
Шарлотт Кемпенаерс-Поч=Кемпенаерс-Поч Ш.,Кемпенаерс-Поч Шарлотт
Луиза Стефани=Стефани Л.,Стефани Луиза
Онс Жабер=Жабер О.,Жабер Онс
Фанни Штолляр=Штолляр Ф.,Штолляр Фанни
Фернанда Контрерас Гомес=Контрерас Гомес Ф.,Контрерас Гомес Фернанда
Каролина Алвес=Алвес К.,Алвес Каролина
Катажина Кава=Кава К.,Кава Катажина
Джулия Морле=Морле Д.,Морле Джулия
Элисон Ван Эйтванк=Ван Эйтванк Э.,Ван Эйтванк Элисон
Конни Перрин=Перрин К.,Перрин Конни
Чжан Юйсюань=Юйсюань Ч.,Юйсюань Чжан
Клэр Лю=Лю К.,Лю Клэр
Валерия Страхова=Страхова В.,Страхова Валерия
Даниэла Сегель=Сегель Д.,Сегель Даниэла
Даниэла Висмане=Висмане Д.,Висмане Даниэла
Полона Херцог=Херцог П.,Херцог Полона
Акгуль Аманмурадова=Аманмурадова А.,Аманмурадова Акгуль
Марина Бассольс Рибера=Бассольс Рибера М.,Бассольс Рибера Марина
Джессика Плазас=Плазас Д.,Плазас Джессика
Пиангтарн Плипыч=Плипыч П.,Плипыч Пиангтарн
Мелани Стокке=Стокке М.,Стокке Мелани
Дженнифер Эли=Эли Д.,Эли Дженнифер
Юрико Миядзаки=Миядзаки Ю.,Миядзаки Юрико
Сесил Каратанчева=Каратанчева С.,Каратанчева Сесил
Елена Остапенко=Остапенко Е.,Остапенко Елена
Виктория Голубич=Голубич В.,Голубич Виктория
Джаклин Како=Како Д.,Како Джаклин
Аранча Рус=Рус А.,Рус Аранча
Хуа-Чень Ли=Ли Х.,Ли Хуа-Чень
Лара Арруабаррена=Арруабаррена Л.,Арруабаррена Лара
Мартина Колменья=Колменья М.,Колменья Мартина
Эмили Эпплтон=Эпплтон Э.,Эпплтон Эмили
Жюли Бельграве=Бельграве Ж.,Бельграве Жюли
Катарина Хобгарски=Хобгарски К.,Хобгарски Катарина
Шанталь Саувант=Саувант Ш.,Саувант Шанталь
Рената Сарасуа=Сарасуа Р.,Сарасуа Рената
Пак Со Юн=Со Юн П.,Со Юн Пак
Софья Шапатава=Шапатава С.,Шапатава Софья
Анхела Фита Болуда=Фита Болуда А.,Фита Болуда Анхела
Тереза Мартинцова=Мартинцова Т.,Мартинцова Тереза
Андреа Ласаро Гарсия=Ласаро Гарсия А.,Ласаро Гарсия Андреа
Улрикке Эйкери=Эйкери У.,Эйкери Улрикке
Магали Кемпен=Кемпен М.,Кемпен Магали
Катерина Козлова=Козлова К.,Козлова Катерина
Диан Парри=Парри Д.,Парри Диан
Моюка Учижима=Учижима М.,Учижима Моюка
Жива Фалкнер=Фалкнер Ж.,Фалкнер Жива
Джессика Пегула=Пегула Д.,Пегула Джессика
Ирина Хромачёва=Хромачёва И.,Хромачёва Ирина
Ирина Бара=Бара И.,Бара Ирина
Леся Цуренко=Цуренко Л.,Цуренко Леся
Нахо Сато=Сато Н.,Сато Нахо
Ива Приморац=Приморац И.,Приморац Ива
Мэдисон Кис=Кис М.,Кис Мэдисон
Нурия Парризас-Диас=Парризас-Диас Н.,Парризас-Диас Нурия
Ангелина Габуева=Габуева А.,Габуева Ангелина
Чжэн Ушуан=Ушуан Ч.,Ушуан Чжэн
Мария-Паулина Перес-Гарсия=Перес-Гарсия М.,Перес-Гарсия Мария-Паулина
Мананчэйа Савангкаев=Савангкаев М.,Савангкаев Мананчэйа
Джессика Бузас Манейро=Бузас Манейро Д.,Бузас Манейро Джессика
Вероника Сепеде-Ройг=Сепеде-Ройг В.,Сепеде-Ройг Вероника
Далила Якупович=Якупович Д.,Якупович Далила
Майо Хиби=Хиби М.,Хиби Майо
Осеан Бабель=Бабель О.,Бабель Осеан
Шелби Роджерс=Роджерс Ш.,Роджерс Шелби
Саманта Маррей=Маррей С.,Маррей Саманта
Лу Цзяцзин=Цзяцзин Л.,Цзяцзин Лу
Элизабет Мандлик=Мандлик Э.,Мандлик Элизабет
Фатма Аль-Набхани=Аль-Набхани Ф.,Аль-Набхани Фатма
Алекса Ноэль=Ноэль А.,Ноэль Алекса
Одри Альби=Альби О.,Альби Одри
Джан Су Джон=Су Джон Д.,Су Джон Джан
Вера Лапко=Лапко В.,Лапко Вера
Тесс Суно=Суно Т.,Суно Тесс
Мария-Камила Осорио-Серрано=Осорио-Серрано М.,Осорио-Серрано Мария-Камила
Кэтрин Харрисон=Харрисон К.,Харрисон Кэтрин
Джейми Форлис=Форлис Д.,Форлис Джейми
Сабина Шарипова=Шарипова С.,Шарипова Сабина
Гозаль Айнитдинова=Айнитдинова Г.,Айнитдинова Гозаль
Шанель Симмондс=Симмондс Ш.,Симмондс Шанель
Джоанна Гарланд=Гарланд Д.,Гарланд Джоанна
Кимберли Биррелл=Биррелл К.,Биррелл Кимберли
Мейлин Алёме=Алёме М.,Алёме Мейлин
Настасья-Мариана Шунк=Шунк Н.,Шунк Настасья-Мариана
София Уиттл=Уиттл С.,Уиттл София
Мари Осака=Осака М.,Осака Мари
Михару Иманиси=Иманиси М.,Иманиси Михару
Кая Юван=Юван К.,Юван Кая
Анастасия Тихонова=Тихонова А.,Тихонова Анастасия
Александра Киик=Киик А.,Киик Александра
Карсон Брэнстин=Брэнстин К.,Брэнстин Карсон
Жаклин Кристиан=Кристиан Ж.,Кристиан Жаклин
Сабина Лисицки=Лисицки С.,Лисицки Сабина
Ивонн Кавалье-Реймерс=Кавалье-Реймерс И.,Кавалье-Реймерс Ивонн
Мэйци Го=Го М.,Го Мэйци
Харука Кадзи=Кадзи Х.,Кадзи Харука
Синья Краус=Краус С.,Краус Синья
Дария Юрак=Юрак Д.,Юрак Дария
Нина Стоянович=Стоянович Н.,Стоянович Нина
Лю Фанчжу=Фанчжу Л.,Фанчжу Лю
Монсеррат Гонсалес=Гонсалес М.,Гонсалес Монсеррат
Майя Хвалинска=Хвалинска М.,Хвалинска Майя
Оливия Роговска=Роговска О.,Роговска Оливия
Эрина Хаяси=Хаяси Э.,Хаяси Эрина
Стефани Вагнер=Вагнер С.,Вагнер Стефани
Карла Суарес-Наварро=Суарес-Наварро К.,Суарес-Наварро Карла
Беатрис Хаддад-Майя=Хаддад-Майя Б.,Хаддад-Майя Беатрис
Сюнь Фанъин=Фанъин С.,Фанъин Сюнь
Марина Чернышова=Чернышова М.,Чернышова Марина
Анастасия Шошина=Шошина А.,Шошина Анастасия
Паула Бадоса=Бадоса П.,Бадоса Паула
Фрейя Кристи=Кристи Ф.,Кристи Фрейя
Анастасия Гасанова=Гасанова А.,Гасанова Анастасия
Ингрид Нил=Нил И.,Нил Ингрид
Даниэль Коллинз=Коллинз Д.,Коллинз Даниэль
Мию Като=Като М.,Като Мию
Анна Кубарева=Кубарева А.,Кубарева Анна
Татьяна Пьери=Пьери Т.,Пьери Татьяна
Марина Юданов=Юданов М.,Юданов Марина
Люси Гавличкова=Гавличкова Л.,Гавличкова Люси
Каролина Кубанёва=Кубанёва К.,Кубанёва Каролина
Анна Калинская=Калинская А.,Калинская Анна
Пэн Шуай=Шуай П.,Шуай Пэн
Елена Рыбакина=Рыбакина Е.,Рыбакина Елена
Алёна Большова=Большова А.,Большова Алёна
Михаэла Бузэрнеску=Бузэрнеску М.,Бузэрнеску Михаэла
Джоди Бёррэдж=Бёррэдж Д.,Бёррэдж Джоди
Анжелика Кербер=Кербер А.,Кербер Анжелика
Чжу Линь=Линь Ч.,Линь Чжу
Ирина Рамьялисон=Рамьялисон И.,Рамьялисон Ирина
Камилла Скала=Скала К.,Скала Камилла
Дениса Шатралова=Шатралова Д.,Шатралова Дениса
Шераза Рейкс=Рейкс Ш.,Рейкс Шераза
Эмбер Маршалл=Маршалл Э.,Маршалл Эмбер
Эрика Андреева=Андреева Э.,Андреева Эрика
Оливия Тжандрамулия=Тжандрамулия О.,Тжандрамулия Оливия
Сюзанн Селик=Селик С.,Селик Сюзанн
Анкита Раина=Раина А.,Раина Анкита
Меи Ямагучи=Ямагучи М.,Ямагучи Меи
Арина Родионова=Родионова А.,Родионова Арина
Деа Хердзелаш=Хердзелаш Д.,Хердзелаш Деа
Екатерина Александрова=Александрова Е.,Александрова Екатерина
Вероника Фальковская=Фальковская В.,Фальковская Вероника
Анна Данилина=Данилина А.,Данилина Анна
Федерика Ди Сарра=Ди Сарра Ф.,Ди Сарра Федерика
Габриэлла Тейлор=Тейлор Г.,Тейлор Габриэлла
Александра Вечич=Вечич А.,Вечич Александра
Тэйлор Таунсенд=Таунсенд Т.,Таунсенд Тэйлор
Рената Ворачова=Ворачова Р.,Ворачова Рената
Катинка фон Дайхман=фон Дайхман К.,фон Дайхман Катинка
Паула Ормаэчеа=Ормаэчеа П.,Ормаэчеа Паула
Анна Познихиренко=Познихиренко А.,Познихиренко Анна
Бернарда Пера=Пера Б.,Пера Бернарда
Каролина Вернер=Вернер К.,Вернер Каролина
Синьюй Ван=Ван С.,Ван Синьюй
Барбара Хаас=Хаас Б.,Хаас Барбара
Дия Евтимова=Евтимова Д.,Евтимова Дия
Патрисия-Мария Циг=Циг П.,Циг Патрисия-Мария
Малене Хельгё=Хельгё М.,Хельгё Малене
Манон Арканьоли=Арканьоли М.,Арканьоли Манон
Александра Епифанова=Епифанова А.,Епифанова Александра
Кароль Монне=Монне К.,Монне Кароль
Лаура-Иоана Паар=Паар Л.,Паар Лаура-Иоана
Эден Сильва=Сильва Э.,Сильва Эден
Зои-Гвен Скэндалис=Скэндалис З.,Скэндалис Зои-Гвен
Шоу На Му=На Му Ш.,На Му Шоу
Питон Стирнс=Стирнс П.,Стирнс Питон
Михаэла Кадлецкова=Кадлецкова М.,Кадлецкова Михаэла
Энн Ли=Ли Э.,Ли Энн
Барбора Стрыцова=Стрыцова Б.,Стрыцова Барбора
Александра Перпер=Перпер А.,Перпер Александра
Людмила Самсонова=Самсонова Л.,Самсонова Людмила
Шанталь Шкамлова=Шкамлова Ш.,Шкамлова Шанталь
Юань Юэ=Юэ Ю.,Юэ Юань
Куинн Глисон=Глисон К.,Глисон Куинн
Мисаки Дои=Дои М.,Дои Мисаки
Корнелия Листер=Листер К.,Листер Корнелия
Ребекка Шрамкова=Шрамкова Р.,Шрамкова Ребекка
Яна Фетт=Фетт Я.,Фетт Яна
Ханьюй Го=Го Х.,Го Ханьюй
Мария Матеас=Матеас М.,Матеас Мария
Аяка Окуно=Окуно А.,Окуно Аяка
Андрея Присэкариу=Присэкариу А.,Присэкариу Андрея
Юлия Глушко=Глушко Ю.,Глушко Юлия
Наоми Броэди=Броэди Н.,Броэди Наоми
Влада Коваль=Коваль В.,Коваль Влада
Элисон Риске=Риске Э.,Риске Элисон
Кристина Плишкова=Плишкова К.,Плишкова Кристина
Кэтрин Себов=Себов К.,Себов Кэтрин
Тельяна Перейра=Перейра Т.,Перейра Тельяна
Анастасия Севастова=Севастова А.,Севастова Анастасия
Наташа Субхаш=Субхаш Н.,Субхаш Наташа
Лига Декмейере=Декмейере Л.,Декмейере Лига
Стефания Рубини=Рубини С.,Рубини Стефания
Олександра Олийникова=Олийникова О.,Олийникова Олександра
София Севинг=Севинг С.,Севинг София
Коко Вандевей=Вандевей К.,Вандевей Коко
Хон Йи Коди Вон=Йи Коди Вон Х.,Йи Коди Вон Хон
Эмма Радукану=Радукану Э.,Радукану Эмма
Хироко Кувата=Кувата Х.,Кувата Хироко
Ким Клейстерс=Клейстерс К.,Клейстерс Ким
Петра Мартич=Мартич П.,Мартич Петра
Марсела Сакарьяс=Сакарьяс М.,Сакарьяс Марсела
Дарья Кружкова=Кружкова Д.,Кружкова Дарья
Зарина Дияс=Дияс З.,Дияс Зарина
Эмили Уэбли-Смит=Уэбли-Смит Э.,Уэбли-Смит Эмили
Мирьям Бьёрклунд=Бьёрклунд М.,Бьёрклунд Мирьям
Мария Гутьеррес Карраско=Гутьеррес Карраско М.,Гутьеррес Карраско Мария
Йоана Маркова=Маркова Й.,Маркова Йоана
Кристина Кучова=Кучова К.,Кучова Кристина
Винус Уильямс=Уильямс В.,Уильямс Винус
Паула-Кристина Гонсалвес=Гонсалвес П.,Гонсалвес Паула-Кристина
Анфиса Данильченко=Данильченко А.,Данильченко Анфиса
Пиа Ловрич=Ловрич П.,Ловрич Пиа
Алёна Фомина=Фомина А.,Фомина Алёна
Эстелль Кашино=Кашино Э.,Кашино Эстелль
Тена Лукас=Лукас Т.,Лукас Тена
Елица Костова=Костова Е.,Костова Елица
Есика Малецкова=Малецкова Е.,Малецкова Есика
Гретье Миннен=Миннен Г.,Миннен Гретье
Кэти Волынец=Волынец К.,Волынец Кэти
Юстина Микульските=Микульските Ю.,Микульските Юстина
Мария Саккари=Саккари М.,Саккари Мария
Линда Фрухвиртова=Фрухвиртова Л.,Фрухвиртова Линда
Антония Лоттнер=Лоттнер А.,Лоттнер Антония
Фанни Остлунд=Остлунд Ф.,Остлунд Фанни
Михаэла Гончова=Гончова М.,Гончова Михаэла
Лейла Фернандес=Фернандес Л.,Фернандес Лейла
Ева Рашкевич=Рашкевич Е.,Рашкевич Ева
Надия Эчеверрия-Алам=Эчеверрия-Алам Н.,Эчеверрия-Алам Надия
Мартина Карегаро=Карегаро М.,Карегаро Мартина
Мартина Ди Джузеппе=Ди Джузеппе М.,Ди Джузеппе Мартина
Валерия Савиных=Савиных В.,Савиных Валерия
Романа Цисовска=Цисовска Р.,Цисовска Романа
Бетани Маттек-Сэндс=Маттек-Сэндс Б.,Маттек-Сэндс Бетани
Сара Томич=Томич С.,Томич Сара
Мира Антонич=Антонич М.,Антонич Мира
Деспина Папамихаил=Папамихаил Д.,Папамихаил Деспина
Каролин Ромео=Ромео К.,Ромео Каролин
Деяна Раданович=Раданович Д.,Раданович Деяна
Ин Чжан=Чжан И.,Чжан Ин
Катерина Бондаренко=Бондаренко К.,Бондаренко Катерина
Берфу Ченгиз=Ченгиз Б.,Ченгиз Берфу
Магда Линетт=Линетт М.,Линетт Магда
Янина Викмайер=Викмайер Я.,Викмайер Янина
Варвара Флинк=Флинк В.,Флинк Варвара
Софья Жук=Жук С.,Жук Софья
Виктория Хименес-Касинцева=Хименес-Касинцева В.,Хименес-Касинцева Виктория
У Хо-Чинь=Хо-Чинь У.,Хо-Чинь У
Ли Ясюань=Ясюань Л.,Ясюань Ли
Ольга Данилович=Данилович О.,Данилович Ольга
Река-Луца Яни=Яни Р.,Яни Река-Луца
Кристиана Феррандо=Феррандо К.,Феррандо Кристиана
Натали Курата=Курата Н.,Курата Натали
Белинда Вулкок=Вулкок Б.,Вулкок Белинда
Софи Чанг=Чанг С.,Чанг Софи
Ольга Дорошина=Дорошина О.,Дорошина Ольга
Присцилла Хон=Хон П.,Хон Присцилла
Басак Ерайдин=Ерайдин Б.,Ерайдин Басак
Лу Бруло=Бруло Л.,Бруло Лу
Чжосюань Бай=Бай Ч.,Бай Чжосюань
Мария Карле=Карле М.,Карле Мария
Араван Резаи=Резаи А.,Резаи Араван
Верена Мелисс=Мелисс В.,Мелисс Верена
Данка Ковинич=Ковинич Д.,Ковинич Данка
Фернанда Брито=Брито Ф.,Брито Фернанда
Дарья Лодикова=Лодикова Д.,Лодикова Дарья
Катрин Беллис=Беллис К.,Беллис Катрин
Се Шувэй=Шувэй С.,Шувэй Се
Цветана Пиронкова=Пиронкова Ц.,Пиронкова Цветана
Виктория Родригес=Родригес В.,Родригес Виктория
Лизетт Кабрера=Кабрера Л.,Кабрера Лизетт
Лина Джёрческа=Джёрческа Л.,Джёрческа Лина
Софья Кенин=Кенин С.,Кенин Софья
Ольга Янчук=Янчук О.,Янчук Ольга
Митика Одзеки=Одзеки М.,Одзеки Митика
Ане Минтехи Дель Ольмо=Минтехи Дель Ольмо А.,Минтехи Дель Ольмо Ане
Риз Брантмайер=Брантмайер Р.,Брантмайер Риз
Мартина Спигарелли=Спигарелли М.,Спигарелли Мартина
Екатерина Яшина=Яшина Е.,Яшина Екатерина
Дебора Кьеза=Кьеза Д.,Кьеза Дебора
Виктория Томова=Томова В.,Томова Виктория
Нигина Абдураимова=Абдураимова Н.,Абдураимова Нигина
Нацуми Кавагути=Кавагути Н.,Кавагути Нацуми
Елена Малыгина=Малыгина Е.,Малыгина Елена
Софья Лансере=Лансере С.,Лансере Софья
Катарина Завацкая=Завацкая К.,Завацкая Катарина
Кристина Младенович=Младенович К.,Младенович Кристина
Нома Ноа-Акугуэ=Ноа-Акугуэ Н.,Ноа-Акугуэ Нома
Чичи Шолл=Шолл Ч.,Шолл Чичи
Лара Сальден=Сальден Л.,Сальден Лара
Гуйомар Маристани Сулета Де Реалес=Маристани Сулета Де Реалес Г.,Маристани Сулета Де Реалес Гуйомар
Сандра Самир=Самир С.,Самир Сандра
Жибек Куламбаева=Куламбаева Ж.,Куламбаева Жибек
Панна Удварди=Удварди П.,Удварди Панна
Варвара Лепченко=Лепченко В.,Лепченко Варвара
Чжан Шуай=Шуай Ч.,Шуай Чжан
Дарья Астахова=Астахова Д.,Астахова Дарья
Алисия Барнетт=Барнетт А.,Барнетт Алисия
Рутуя Босейл=Босейл Р.,Босейл Рутуя
Йоханна Конта=Конта Й.,Конта Йоханна
Тара Мур=Мур Т.,Мур Тара
Осеан Доден=Доден О.,Доден Осеан
Тамара Чурович=Чурович Т.,Чурович Тамара
Сюй Цзеюй=Цзеюй С.,Цзеюй Сюй
Элина Свитолина=Свитолина Э.,Свитолина Элина
Лукреция Стефанини=Стефанини Л.,Стефанини Лукреция
Люция Градецка=Градецка Л.,Градецка Люция
Лорен Дэвис=Дэвис Л.,Дэвис Лорен
Ян Чжаосюань=Чжаосюань Я.,Чжаосюань Ян
Вероника Башак=Башак В.,Башак Вероника
Кагла Буюкаксай=Буюкаксай К.,Буюкаксай Кагла
Дабин Ким=Ким Д.,Ким Дабин
Влада Екшибарова=Екшибарова В.,Екшибарова Влада
Илена Ин-Альбон=Ин-Альбон И.,Ин-Альбон Илена
Шалимар Тальби=Тальби Ш.,Тальби Шалимар
Тесса Андрианжафитримо=Андрианжафитримо Т.,Андрианжафитримо Тесса
Габриэлла Да Сильва Фик=Да Сильва Фик Г.,Да Сильва Фик Габриэлла
Исалин Бонавентюр=Бонавентюр И.,Бонавентюр Исалин
Тан Цяньхуэй=Цяньхуэй Т.,Цяньхуэй Тан
Зои Хивз=Хивз З.,Хивз Зои
Каролина Мухова=Мухова К.,Мухова Каролина
Джессика Пьери=Пьери Д.,Пьери Джессика
Андрея Рошка=Рошка А.,Рошка Андрея
Макото Ниномия=Ниномия М.,Ниномия Макото
Марион Вьертлер=Вьертлер М.,Вьертлер Марион
Сорана Кырстя=Кырстя С.,Кырстя Сорана
Ана Конюх=Конюх А.,Конюх Ана
Амина Аншба=Аншба А.,Аншба Амина
Карман Танди=Танди К.,Танди Карман
Кимберли Циммерманн=Циммерманн К.,Циммерманн Кимберли
Элизабетта Коччаретто=Коччаретто Э.,Коччаретто Элизабетта
Лулу Сун=Сун Л.,Сун Лулу
Элисе Мертенс=Мертенс Э.,Мертенс Элисе
Елизавета Коклина=Коклина Е.,Коклина Елизавета
Елена-Габриэла Русе=Русе Е.,Русе Елена-Габриэла
Анастасия Детюк=Детюк А.,Детюк Анастасия
Сунь Цзыюэ=Цзыюэ С.,Цзыюэ Сунь
Виталия Дьяченко=Дьяченко В.,Дьяченко Виталия
Настассья Бурнетт=Бурнетт Н.,Бурнетт Настассья
Линда Носкова=Носкова Л.,Носкова Линда
Эмма Наварро=Наварро Э.,Наварро Эмма
Констанс Сибиль=Сибиль К.,Сибиль Констанс
Анна Зая=Зая А.,Зая Анна
Тимя Бачински=Бачински Т.,Бачински Тимя
Патчарин Чипчандей=Чипчандей П.,Чипчандей Патчарин
Оона Орпана=Орпана О.,Орпана Оона
Ивана Попович=Попович И.,Попович Ивана
Виктория Мунтян=Мунтян В.,Мунтян Виктория
Анастасия Потапова=Потапова А.,Потапова Анастасия
Тори Кинард=Кинард Т.,Кинард Тори
Эшлин Крюгер=Крюгер Э.,Крюгер Эшлин
Фиона Ферро=Ферро Ф.,Ферро Фиона
Валентини Грамматикопулу=Грамматикопулу В.,Грамматикопулу Валентини
Робин Андерсон=Андерсон Р.,Андерсон Робин
Маллори Ноэль=Ноэль М.,Ноэль Маллори
Маргарита Гаспарян=Гаспарян М.,Гаспарян Маргарита
Мартина Тревизан=Тревизан М.,Тревизан Мартина
Тэйлор Нг=Нг Т.,Нг Тэйлор
Рия Бхатия=Бхатия Р.,Бхатия Рия
Аманден Эсс=Эсс А.,Эсс Аманден
Анна Турати=Турати А.,Турати Анна
Эвита Рамирес=Рамирес Э.,Рамирес Эвита
Ксения Кнолль=Кнолль К.,Кнолль Ксения
Нг Кванъяу=Кванъяу Н.,Кванъяу Нг
Ван Цян=Цян В.,Цян Ван
Сада Нахимана=Нахимана С.,Нахимана Сада
Сихо Акита=Акита С.,Акита Сихо
Александра Божович=Божович А.,Божович Александра
Кристина Бушкэ=Бушкэ К.,Бушкэ Кристина
Грэйс Мин=Мин Г.,Мин Грэйс
Каталина Пелья=Пелья К.,Пелья Каталина
Момоко Кобори=Кобори М.,Кобори Момоко
Кирин Лемуан=Лемуан К.,Лемуан Кирин
Йована Йович=Йович Й.,Йович Йована
Виктория Дема=Дема В.,Дема Виктория
Мона Бартель=Бартель М.,Бартель Мона
Стефани Фёгель=Фёгель С.,Фёгель Стефани
Петра Квитова=Квитова П.,Квитова Петра
Мария Козырева=Козырева М.,Козырева Мария
Пиа Цук=Цук П.,Цук Пиа
Адриенн Надь=Надь А.,Надь Адриенн
Анастасия Зарыцка=Зарыцка А.,Зарыцка Анастасия
Ханна Чанг=Чанг Х.,Чанг Ханна
Эшли Барти=Барти Э.,Барти Эшли
Джулиана Олмос=Олмос Д.,Олмос Джулиана
Сара Бейлек=Бейлек С.,Бейлек Сара
Хиль Белен Тайхман=Белен Тайхман Х.,Белен Тайхман Хиль
Жаклин Кабай Авад=Кабай Авад Ж.,Кабай Авад Жаклин
Диана Марцинкевич=Марцинкевич Д.,Марцинкевич Диана
Эдис Чун=Чун Э.,Чун Эдис
Эна Шибахара=Шибахара Э.,Шибахара Эна
Полина Лейкина=Лейкина П.,Лейкина Полина
Дезире Кравчик=Кравчик Д.,Кравчик Дезире
Лола Радивоевич=Радивоевич Л.,Радивоевич Лола
Кристина Макхэйл=Макхэйл К.,Макхэйл Кристина
Николь Фосса-Уэрго=Фосса-Уэрго Н.,Фосса-Уэрго Николь
Эва Веддер=Веддер Э.,Веддер Эва
Арина Соболенко=Соболенко А.,Соболенко Арина
Валерия Ющенко=Ющенко В.,Ющенко Валерия
Франческа ди Лоренцо=ди Лоренцо Ф.,ди Лоренцо Франческа
Яна Сизикова=Сизикова Я.,Сизикова Яна
Лейре Ромеро Гормас=Ромеро Гормас Л.,Ромеро Гормас Лейре
Сиюй Ван=Ван С.,Ван Сиюй
Кайла Макфи=Макфи К.,Макфи Кайла
Кэйти Бултер=Бултер К.,Бултер Кэйти
Юлия Миддендорф=Миддендорф Ю.,Миддендорф Юлия
Нао Хибино=Хибино Н.,Хибино Нао
Анастасия Нефёдова=Нефёдова А.,Нефёдова Анастасия
Лиза Сабино=Сабино Л.,Сабино Лиза
Саманта Стосур=Стосур С.,Стосур Саманта
Барбора Штефкова=Штефкова Б.,Штефкова Барбора
Тара Вюрт=Вюрт Т.,Вюрт Тара
Мелания Делаи=Делаи М.,Делаи Мелания
Каролин Гарсия=Гарсия К.,Гарсия Каролин
Алисия Паркс=Паркс А.,Паркс Алисия
Пемра Озген=Озген П.,Озген Пемра
Ирина Фалькони=Фалькони И.,Фалькони Ирина
Анастасия Прибылова=Прибылова А.,Прибылова Анастасия
Ника Кухарчук=Кухарчук Н.,Кухарчук Ника
Миртиль Жорж=Жорж М.,Жорж Миртиль
Роми Кольцер=Кольцер Р.,Кольцер Роми
Леа Бошкович=Бошкович Л.,Бошкович Леа
Ванг Меилинг=Меилинг В.,Меилинг Ванг
Виктория Кан=Кан В.,Кан Виктория
Анна Сискова=Сискова А.,Сискова Анна
Дарья Лопатецкая=Лопатецкая Д.,Лопатецкая Дарья
Александра Эала=Эала А.,Эала Александра
Сара-Ребекка Секулич=Секулич С.,Секулич Сара-Ребекка
Лаура Шедер=Шедер Л.,Шедер Лаура
Джоанне Цугер=Цугер Д.,Цугер Джоанне
Тереза Шмиткова=Шмиткова Т.,Шмиткова Тереза
Валерия Оляновская=Оляновская В.,Оляновская Валерия
Алдила Сутджиади=Сутджиади А.,Сутджиади Алдила
Ольга Саэс Ларра=Саэс Ларра О.,Саэс Ларра Ольга
Ивонн Нойвирт=Нойвирт И.,Нойвирт Ивонн
Екатерина Макарова=Макарова Е.,Макарова Екатерина
Полина Кудерметова=Кудерметова П.,Кудерметова Полина
Ева Герреро Альварес=Герреро Альварес Е.,Герреро Альварес Ева
Моника Килнарова=Килнарова М.,Килнарова Моника
Оана-Георгета Симион=Симион О.,Симион Оана-Георгета
Харрикейн Блэк=Блэк Х.,Блэк Харрикейн
Анастасия Захарова=Захарова А.,Захарова Анастасия
Полина Монова=Монова П.,Монова Полина
Таисия Мордергер=Мордергер Т.,Мордергер Таисия
Хэрриет Дарт=Дарт Х.,Дарт Хэрриет
Алиша Смит=Смит А.,Смит Алиша
Вивьен Югасзова=Югасзова В.,Югасзова Вивьен
Яна Чепелова=Чепелова Я.,Чепелова Яна
Магдалена Фрех=Фрех М.,Фрех Магдалена
Дарья Гаврилова=Гаврилова Д.,Гаврилова Дарья
Ван Яфань=Яфань В.,Яфань Ван
Ю Сяоди=Сяоди Ю.,Сяоди Ю
Эри Ходзуми=Ходзуми Э.,Ходзуми Эри
Яна Мордергер=Мордергер Я.,Мордергер Яна
Праняла Ядлапалли=Ядлапалли П.,Ядлапалли Праняла
Франсуаза Абанда=Абанда Ф.,Абанда Франсуаза
Элина Аванесян=Аванесян Э.,Аванесян Элина
Наги Ханатани=Ханатани Н.,Ханатани Наги
Джульетта Штойр=Штойр Д.,Штойр Джульетта
Надежда Киченок=Киченок Н.,Киченок Надежда
Эмина Бектас=Бектас Э.,Бектас Эмина
Кэрол Чжао=Чжао К.,Чжао Кэрол
Дженнифер Брэйди=Брэйди Д.,Брэйди Дженнифер
Сара Цакаревич=Цакаревич С.,Цакаревич Сара
Людмила Бенчех=Бенчех Л.,Бенчех Людмила
Ясмине Паолини=Паолини Я.,Паолини Ясмине
Эллен Перес=Перес Э.,Перес Эллен
Ксения Ласкутова=Ласкутова К.,Ласкутова Ксения
Мария Тимофеева=Тимофеева М.,Тимофеева Мария
Селена Яникижевич=Яникижевич С.,Яникижевич Селена
Мияби Иноуэ=Иноуэ М.,Иноуэ Мияби
Зузана Злокова=Злокова З.,Злокова Зузана
Лена Рюффер=Рюффер Л.,Рюффер Лена
Лаура Пигосси=Пигосси Л.,Пигосси Лаура
Ализе Корне=Корне А.,Корне Ализе
Сара Бет Грей=Бет Грей С.,Бет Грей Сара
Анна Шмидлова=Шмидлова А.,Шмидлова Анна
Екатерина Горгодзе=Горгодзе Е.,Горгодзе Екатерина
Юлия Готовко=Готовко Ю.,Готовко Юлия
Кэти Данн=Данн К.,Данн Кэти
Вероника Кудерметова=Кудерметова В.,Кудерметова Вероника
Марта Костюк=Костюк М.,Костюк Марта
Эжени Бушар=Бушар Э.,Бушар Эжени
Мана Аюкава=Аюкава М.,Аюкава Мана
Бриана Сабо=Сабо Б.,Сабо Бриана
Манон Леонар=Леонар М.,Леонар Манон
Ана Богдан=Богдан А.,Богдан Ана
Андреа Миту=Миту А.,Миту Андреа
Донна Векич=Векич Д.,Векич Донна
Мэнди Минелла=Минелла М.,Минелла Мэнди
Мария Санчес=Санчес М.,Санчес Мария
Александра Саснович=Саснович А.,Саснович Александра
Владица Бабич=Бабич В.,Бабич Владица
Мара Гут=Гут М.,Гут Мара
Джейми Лоб=Лоб Д.,Лоб Джейми
Изабель Уоллес=Уоллес И.,Уоллес Изабель
Анастасия Золотарёва=Золотарёва А.,Золотарёва Анастасия
Хейли Баптист=Баптист Х.,Баптист Хейли
Юки Наито=Наито Ю.,Наито Юки
Ингрид Гамарра-Мартинс=Гамарра-Мартинс И.,Гамарра-Мартинс Ингрид
Эрика Сема=Сема Э.,Сема Эрика
Ралука Шербан=Шербан Р.,Шербан Ралука
Алис Рам=Рам А.,Рам Алис
Синди Бургер=Бургер С.,Бургер Синди
Габриэла Се=Се Г.,Се Габриэла
Селестин Авомо Элла=Авомо Элла С.,Авомо Элла Селестин
Ана-София Санчес=Санчес А.,Санчес Ана-София
Акико Омаэ=Омаэ А.,Омаэ Акико
Анна-Лена Фридзам=Фридзам А.,Фридзам Анна-Лена
Мириам Колодзьежова=Колодзьежова М.,Колодзьежова Мириам
Андреа Петкович=Петкович А.,Петкович Андреа
Сюзан Ламенс=Ламенс С.,Ламенс Сюзан
Нурия Бранкаччо=Бранкаччо Н.,Бранкаччо Нурия
Хелен Шольсен=Шольсен Х.,Шольсен Хелен
Тамара Бижукова=Бижукова Т.,Бижукова Тамара
Александра Крунич=Крунич А.,Крунич Александра
Алина Чараева=Чараева А.,Чараева Алина
Николета Даскэлу=Даскэлу Н.,Даскэлу Николета
Уитни Осуйве=Осуйве У.,Осуйве Уитни
Мари Боузкова=Боузкова М.,Боузкова Мари
Габриэла Дабровски=Дабровски Г.,Дабровски Габриэла
Камилла Бартоне=Бартоне К.,Бартоне Камилла
Анна Бондарь=Бондарь А.,Бондарь Анна
Ольга Говорцова=Говорцова О.,Говорцова Ольга
Ксения Палкина=Палкина К.,Палкина Ксения
Вивиан Хайзен=Хайзен В.,Хайзен Вивиан
Оксана Селехметьева=Селехметьева О.,Селехметьева Оксана
Варвара Грачёва=Грачёва В.,Грачёва Варвара
Дестани Айава=Айава Д.,Айава Дестани
Мэддисон Инглис=Инглис М.,Инглис Мэддисон
Далма Галфи=Галфи Д.,Галфи Далма
Клаудия Джовине=Джовине К.,Джовине Клаудия
Лиза Пигато=Пигато Л.,Пигато Лиза
Су Нам Чон=Нам Чон С.,Нам Чон Су
Гарбинье Мугуруса=Мугуруса Г.,Мугуруса Гарбинье
Джессика Понше=Понше Д.,Понше Джессика
Виктория Босио=Босио В.,Босио Виктория
Катарина Герлах=Герлах К.,Герлах Катарина
Камила Джорджи=Джорджи К.,Джорджи Камила
Хань Синьюнь=Синьюнь Х.,Синьюнь Хань
Айла Аксу=Аксу А.,Аксу Айла
Анетт Контавейт=Контавейт А.,Контавейт Анетт
Мирьям Булгару=Булгару М.,Булгару Мирьям
Айла Томлянович=Томлянович А.,Томлянович Айла
Ребекка Петерсон=Петерсон Р.,Петерсон Ребекка
Астра Шарма=Шарма А.,Шарма Астра
Харуна Аракава=Аракава Х.,Аракава Харуна
Армони Тан=Тан А.,Тан Армони
Валентина Ивахненко=Ивахненко В.,Ивахненко Валентина
Энь Шо Лян=Шо Лян Э.,Шо Лян Энь
Андреа Гамис=Гамис А.,Гамис Андреа
Хулия Пайола=Пайола Х.,Пайола Хулия
Синьюй Гао=Гао С.,Гао Синьюй
Юлиана Монрой=Монрой Ю.,Монрой Юлиана
Анастасия Гримальска=Гримальска А.,Гримальска Анастасия
Рихел Хогенкамп=Хогенкамп Р.,Хогенкамп Рихел
Джорджия Крэчьюн=Крэчьюн Д.,Крэчьюн Джорджия
Елена Веснина=Веснина Е.,Веснина Елена
Дэниелла Лао=Лао Д.,Лао Дэниелла
Франческа Джонс=Джонс Ф.,Джонс Франческа
Ирен Бурильо Эскорихуэла=Бурильо Эскорихуэла И.,Бурильо Эскорихуэла Ирен
Каролина Плишкова=Плишкова К.,Плишкова Каролина
Коринна Дентони=Дентони К.,Дентони Коринна
Приска Маделин Нугрохо=Маделин Нугрохо П.,Маделин Нугрохо Приска
Алекса Глатч=Глатч А.,Глатч Алекса
Дзюнри Намигата=Намигата Д.,Намигата Дзюнри
Мария Эрасо-Гонсалес=Эрасо-Гонсалес М.,Эрасо-Гонсалес Мария
Пэйдж Мэри Хуриган=Мэри Хуриган П.,Мэри Хуриган Пэйдж
Лесли Керкхове=Керкхове Л.,Керкхове Лесли
Кирстен Флипкенс=Флипкенс К.,Флипкенс Кирстен
Цзяци Кан=Кан Ц.,Кан Цзяци
Даяна Ястремская=Ястремская Д.,Ястремская Даяна
Абигаил Тере-Аписа=Тере-Аписа А.,Тере-Аписа Абигаил
Серена Уильямс=Уильямс С.,Уильямс Серена
Лиза Матвиенко=Матвиенко Л.,Матвиенко Лиза
Ирина Бегу=Бегу И.,Бегу Ирина
Татьяна Мария=Мария Т.,Мария Татьяна
Катержина Синякова=Синякова К.,Синякова Катержина
Кристина Эне=Эне К.,Эне Кристина
Евгения Родина=Родина Е.,Родина Евгения
Ванда Лукач=Лукач В.,Лукач Ванда
Ярослава Шведова=Шведова Я.,Шведова Ярослава
Сион Мендес=Мендес С.,Мендес Сион
Моника Пуиг=Пуиг М.,Пуиг Моника
Лючия Бронцетти=Бронцетти Л.,Бронцетти Лючия
Ализе Лим=Лим А.,Лим Ализе
Лаура Зигемунд=Зигемунд Л.,Зигемунд Лаура
Нуднида Луангнам=Луангнам Н.,Луангнам Нуднида
Кейла Дей=Дей К.,Дей Кейла
Агнеш Букта=Букта А.,Букта Агнеш
Дарья Мишина=Мишина Д.,Мишина Дарья
Леолия Жанжан=Жанжан Л.,Жанжан Леолия
Ким Да Хье=Да Хье К.,Да Хье Ким
Куруми Нара=Нара К.,Нара Куруми
Сторм Сэндерс=Сэндерс С.,Сэндерс Сторм
Юлия Вахачик=Вахачик Ю.,Вахачик Юлия
Хитер Уотсон=Уотсон Х.,Уотсон Хитер
Сара Соррибес-Тормо=Соррибес-Тормо С.,Соррибес-Тормо Сара
Зейнеп Сонмез=Сонмез З.,Сонмез Зейнеп
Георгина Гарсия-Перес=Гарсия-Перес Г.,Гарсия-Перес Георгина
Габриэлла Прайс=Прайс Г.,Прайс Габриэлла
Луксика Кумкхум=Кумкхум Л.,Кумкхум Луксика
Марианна Закарлюк=Закарлюк М.,Закарлюк Марианна
Мэдисон Бренгл=Бренгл М.,Бренгл Мэдисон
Анастасия Павлюченкова=Павлюченкова А.,Павлюченкова Анастасия
Жюли Жерво=Жерво Ж.,Жерво Жюли
Камилла Розателло=Розателло К.,Розателло Камилла
Маи Минокоси=Минокоси М.,Минокоси Маи
Арлинда Рушити=Рушити А.,Рушити Арлинда
Петя Аршинкова=Аршинкова П.,Аршинкова Петя
Маи Хонтама=Хонтама М.,Хонтама Маи
Кристи Анн=Анн К.,Анн Кристи
Сачия Викери=Викери С.,Викери Сачия
Таиса-Грана Педретти=Педретти Т.,Педретти Таиса-Грана
Тамара Корпач=Корпач Т.,Корпач Тамара
Оливия Гадеки=Гадеки О.,Гадеки Оливия
Ника Радишич=Радишич Н.,Радишич Ника
Клара Таусон=Таусон К.,Таусон Клара
Элеонора Молинаро=Молинаро Э.,Молинаро Элеонора
Юлия Путинцева=Путинцева Ю.,Путинцева Юлия
Камилла Рахимова=Рахимова К.,Рахимова Камилла
Юлия Грабер=Грабер Ю.,Грабер Юлия
Хэйли Картер=Картер Х.,Картер Хэйли
Йиди Ян=Ян Й.,Ян Йиди
Светлана Кузнецова=Кузнецова С.,Кузнецова Светлана
Оксана Калашникова=Калашникова О.,Калашникова Оксана
Аяно Симидзу=Симидзу А.,Симидзу Аяно
Хан На Лэ=На Лэ Х.,На Лэ Хан
Элисия Болтон=Болтон Э.,Болтон Элисия
Дарья Снигур=Снигур Д.,Снигур Дарья
Симона Халеп=Халеп С.,Халеп Симона
Далила Спитери=Спитери Д.,Спитери Далила
Тереза Мрдежа=Мрдежа Т.,Мрдежа Тереза
Ребека Масарова=Масарова Р.,Масарова Ребека
Нейкта Бэйнс=Бэйнс Н.,Бэйнс Нейкта
Юлия Тержийска=Тержийска Ю.,Тержийска Юлия
Анастасия Комардина=Комардина А.,Комардина Анастасия
Робин Монтгомери=Монтгомери Р.,Монтгомери Робин
Екатерина Шалимова=Шалимова Е.,Шалимова Екатерина
Ли Пэйчи=Пэйчи Л.,Пэйчи Ли
Ивана Йорович=Йорович И.,Йорович Ивана
Маилеен Нууди=Нууди М.,Нууди Маилеен
Анна Моргина=Моргина А.,Моргина Анна
Ююки Танака=Танака Ю.,Танака Ююки
Ипек Оз=Оз И.,Оз Ипек
Габриэла Талаба Ли=Талаба Ли Г.,Талаба Ли Габриэла
Сара Эррани=Эррани С.,Эррани Сара
Юсью Арконада=Арконада Ю.,Арконада Юсью
Элизабет Халбауэр=Халбауэр Э.,Халбауэр Элизабет
Илона-Георгиана Гиороайе=Гиороайе И.,Гиороайе Илона-Георгиана
Сальма Джубри=Джубри С.,Джубри Сальма
Иоана Лоредана Рошка=Лоредана Рошка И.,Лоредана Рошка Иоана
Ванесса Йоана Джорджана Попа Теюсану=Йоана Джорджана Попа Теюсану В.,Йоана Джорджана Попа Теюсану Ванесса
Наоми Осака=Осака Н.,Осака Наоми
Ли Со Ра=Со Ра Л.,Со Ра Ли
Наталия Стеванович=Стеванович Н.,Стеванович Наталия
Луа Буассон=Буассон Л.,Буассон Луа
Кристина Дину=Дину К.,Дину Кристина
Риса Одзаки=Одзаки Р.,Одзаки Риса
Кэйти Суон=Суон К.,Суон Кэйти
Гаэль Десперрье=Десперрье Г.,Десперрье Гаэль
Роса Висенс Мас=Висенс Мас Р.,Висенс Мас Роса
Зина Херрманн=Херрманн З.,Херрманн Зина
Дуань Инъин=Инъин Д.,Инъин Дуань
Барбора Крейчикова=Крейчикова Б.,Крейчикова Барбора
Джейд Суврин=Суврин Д.,Суврин Джейд
Бьянка Андрееску=Андрееску Б.,Андрееску Бьянка
Тимя Бабош=Бабош Т.,Бабош Тимя
Франсишка Жорже=Жорже Ф.,Жорже Франсишка
Александра Дулгеру=Дулгеру А.,Дулгеру Александра
Рита Атик=Атик Р.,Атик Рита
Анджелика Морателли=Морателли А.,Морателли Анджелика
Моника Никулеску=Никулеску М.,Никулеску Моника
Симона Вальтерт=Вальтерт С.,Вальтерт Симона
Эрин Рутлифф=Рутлифф Э.,Рутлифф Эрин
Мэган Мэнасс=Мэнасс М.,Мэнасс Мэган
Дениз Хазанюк=Хазанюк Д.,Хазанюк Дениз
Хлоэ Паке=Паке Х.,Паке Хлоэ
Гэйл Бродски=Бродски Г.,Бродски Гэйл
Екатерина Казионова=Казионова Е.,Казионова Екатерина
Ребекка Марино=Марино Р.,Марино Ребекка
Е Цююй=Цююй Е.,Цююй Е
Цзян Синьюй=Синьюй Ц.,Синьюй Цзян
Катерина Стюарт=Стюарт К.,Стюарт Катерина
Гергана Топалова=Топалова Г.,Топалова Гергана
Клара Бюрель=Бюрель К.,Бюрель Клара
Урсула Радваньска=Радваньска У.,Радваньска Урсула
Бибиан Схофс=Схофс Б.,Схофс Бибиан
Таисия Пачкалева=Пачкалева Т.,Пачкалева Таисия
Чихиро Мурамацу=Мурамацу Ч.,Мурамацу Чихиро
Эльвина Калиева=Калиева Э.,Калиева Эльвина
Маша Йованович=Йованович М.,Йованович Маша
Инди де Вром=де Вром И.,де Вром Инди
Луиза Чирико=Чирико Л.,Чирико Луиза
Мари Бенуа=Бенуа М.,Бенуа Мари
Настя Колар=Колар Н.,Колар Настя
Нефиса Берберович=Берберович Н.,Берберович Нефиса
Виктория Кужмова=Кужмова В.,Кужмова Виктория
Валентина Иванов=Иванов В.,Иванов Валентина
Юле Нимайер=Нимайер Ю.,Нимайер Юле
Гайя Санези=Санези Г.,Санези Гайя
Чжан Кайлинь=Кайлинь Ч.,Кайлинь Чжан
Анна Блинкова=Блинкова А.,Блинкова Анна
Эльза Жакемо=Жакемо Э.,Жакемо Эльза
Аманда Каррерас=Каррерас А.,Каррерас Аманда
Виктория Петренко=Петренко В.,Петренко Виктория
Слоан Стивенс=Стивенс С.,Стивенс Слоан
Ипек Сойлу=Сойлу И.,Сойлу Ипек
Ирина Шиманович=Шиманович И.,Шиманович Ирина
Нина Поточник=Поточник Н.,Поточник Нина
Мелани Клаффнер=Клаффнер М.,Клаффнер Мелани
Сильвия Нирич=Нирич С.,Нирич Сильвия
Сюй Лю Сунь=Лю Сунь С.,Лю Сунь Сюй
Ангелина Калинина=Калинина А.,Калинина Ангелина
Марин Парто=Парто М.,Парто Марин
Марго Йеролимос=Йеролимос М.,Йеролимос Марго
Памела Монтес=Монтес П.,Монтес Памела
Альба Каррильо Марин=Каррильо Марин А.,Каррильо Марин Альба
Вера Звонарёва=Звонарёва В.,Звонарёва Вера
Мария Берген=Берген М.,Берген Мария
Аюми Морита=Морита А.,Морита Аюми
Екатерина Рейнгольд=Рейнгольд Е.,Рейнгольд Екатерина
Маяр Шериф Ахмед Шериф=Шериф Ахмед Шериф М.,Шериф Ахмед Шериф Маяр
Клотильда де Бернарди=де Бернарди К.,де Бернарди Клотильда
Юлиана Лисарасо=Лисарасо Ю.,Лисарасо Юлиана
Бьянка Турати=Турати Б.,Турати Бьянка
Чой Чжи Хи=Чжи Хи Ч.,Чжи Хи Чой
Белинда Бенчич=Бенчич Б.,Бенчич Белинда
Марина Мельникова=Мельникова М.,Мельникова Марина
Катрина Скотт=Скотт К.,Скотт Катрина
Чжэн Циньвэнь=Циньвэнь Ч.,Циньвэнь Чжэн
Виктория Морвайова=Морвайова В.,Морвайова Виктория
Ига Свёнтек=Свёнтек И.,Свёнтек Ига
Дорка Драхота-Сабо=Драхота-Сабо Д.,Драхота-Сабо Дорка
Аманда Анисимова=Анисимова А.,Анисимова Аманда
Анета Лабоуткова=Лабоуткова А.,Лабоуткова Анета
Чан Кайчэнь=Кайчэнь Ч.,Кайчэнь Чан
Леони Кюнг=Кюнг Л.,Кюнг Леони
Катаржина Питер=Питер К.,Питер Катаржина
Элисон Бэй=Бэй Э.,Бэй Элисон
Александр Овчаренко=Овчаренко А.,Овчаренко Александр
Владимир Игнатик=Игнатик В.,Игнатик Владимир
Адельки Вирджили=Вирджили А.,Вирджили Адельки
Хауме Мунар=Мунар Х.,Мунар Хауме
Херардо Лопес-Вильясеньор=Лопес-Вильясеньор Х.,Лопес-Вильясеньор Херардо
Риота Танума=Танума Р.,Танума Риота
Миша Зверев=Зверев М.,Зверев Миша
Гильермо Гарсия-Лопес=Гарсия-Лопес Г.,Гарсия-Лопес Гильермо
Габриэль Пети=Пети Г.,Пети Габриэль
Стефан Робер=Робер С.,Робер Стефан
Уильям Бламберг=Бламберг У.,Бламберг Уильям
Лоран Локоли=Локоли Л.,Локоли Лоран
Чжан Цзэ=Цзэ Ч.,Цзэ Чжан
Кирилл Киватцев=Киватцев К.,Киватцев Кирилл
Люка Пуй=Пуй Л.,Пуй Люка
Мартинс Подзус=Подзус М.,Подзус Мартинс
Пол Джабб=Джабб П.,Джабб Пол
Кристиан Родригес=Родригес К.,Родригес Кристиан
Ли Ту=Ту Л.,Ту Ли
Фернандо Вердаско=Вердаско Ф.,Вердаско Фернандо
Дастин Браун=Браун Д.,Браун Дастин
Штефан Зайферт=Зайферт Ш.,Зайферт Штефан
Найл Оберляйтнер=Оберляйтнер Н.,Оберляйтнер Найл
Хироясу Эхара=Эхара Х.,Эхара Хироясу
Лукас Герх=Герх Л.,Герх Лукас
Каити Утида=Утида К.,Утида Каити
Денис Евсеев=Евсеев Д.,Евсеев Денис
Риккардо Бальдзерани=Бальдзерани Р.,Бальдзерани Риккардо
Марат Шарипов=Шарипов М.,Шарипов Марат
Факундо Хуарес=Хуарес Ф.,Хуарес Факундо
Адам Мундир=Мундир А.,Мундир Адам
Андреас Сеппи=Сеппи А.,Сеппи Андреас
Стюарт Паркер=Паркер С.,Паркер Стюарт
Таллон Грикспор=Грикспор Т.,Грикспор Таллон
Скотт Грикспор=Грикспор С.,Грикспор Скотт
Феликс Корвин=Корвин Ф.,Корвин Феликс
Баи Янь=Янь Б.,Янь Баи
Евгений Донской=Донской Е.,Донской Евгений
Брэдли Клан=Клан Б.,Клан Брэдли
Давид Поляк=Поляк Д.,Поляк Давид
Хуан-Игнасио Лондеро=Лондеро Х.,Лондеро Хуан-Игнасио
Райан Шэйн=Шэйн Р.,Шэйн Райан
Евгений Филиппов=Филиппов Е.,Филиппов Евгений
Рональд Слободчиков=Слободчиков Р.,Слободчиков Рональд
Анас Фаттар=Фаттар А.,Фаттар Анас
Ярослав Шило=Шило Я.,Шило Ярослав
Хосе Оливерас=Оливерас Х.,Оливерас Хосе
Лиам Каруана=Каруана Л.,Каруана Лиам
Рио Ногути=Ногути Р.,Ногути Рио
Корентен Денолли=Денолли К.,Денолли Корентен
Луиджи Соррентино=Соррентино Л.,Соррентино Луиджи
Габор Боршош=Боршош Г.,Боршош Габор
Флорьян Лака=Лака Ф.,Лака Флорьян
Гильерме Клезар=Клезар Г.,Клезар Гильерме
Роберт Галлоуэй=Галлоуэй Р.,Галлоуэй Роберт
Максимильян Мартерер=Мартерер М.,Мартерер Максимильян
Ян Цунхуа=Цунхуа Я.,Цунхуа Ян
Кенни де Шеппер=де Шеппер К.,де Шеппер Кенни
Матиас Сукас=Сукас М.,Сукас Матиас
Георге Цивадзе=Цивадзе Г.,Цивадзе Георге
Факундо Аргуэльо=Аргуэльо Ф.,Аргуэльо Факундо
Максим Пауэлс=Пауэлс М.,Пауэлс Максим
Чун Син Цен=Син Цен Ч.,Син Цен Чун
Джурабек Каримов=Каримов Д.,Каримов Джурабек
Максимильяно Эстевес=Эстевес М.,Эстевес Максимильяно
Марко Миладинович=Миладинович М.,Миладинович Марко
Анис Горбел=Горбел А.,Горбел Анис
Альваро Лопес Сан Мартин=Лопес Сан Мартин А.,Лопес Сан Мартин Альваро
Доминик Келловски=Келловски Д.,Келловски Доминик
Сакет Минени=Минени С.,Минени Сакет
Антуан Белье=Белье А.,Белье Антуан
Алекс де Минор=де Минор А.,де Минор Алекс
Джан Марко Морони=Марко Морони Д.,Марко Морони Джан
Фабиано де Паула=де Паула Ф.,де Паула Фабиано
Петер Полански=Полански П.,Полански Петер
Стефанос Циципас=Циципас С.,Циципас Стефанос
Эмиль Рейнберг=Рейнберг Э.,Рейнберг Эмиль
Александр Донски=Донски А.,Донски Александр
Грегуар Жак=Жак Г.,Жак Грегуар
Леонардо Майер=Майер Л.,Майер Леонардо
Лукас Мидлер=Мидлер Л.,Мидлер Лукас
Ллойд Джордж Харрис=Джордж Харрис Л.,Джордж Харрис Ллойд
Тейлор Фритц=Фритц Т.,Фритц Тейлор
Лучано Дардери=Дардери Л.,Дардери Лучано
Хавьер Барранко Косано=Барранко Косано Х.,Барранко Косано Хавьер
Райан Пенистон=Пенистон Р.,Пенистон Райан
Георгий Кравченко=Кравченко Г.,Кравченко Георгий
Юити Сугита=Сугита Ю.,Сугита Юити
Эрнест Гулбис=Гулбис Э.,Гулбис Эрнест
Антуан Корню Шовен=Корню Шовен А.,Корню Шовен Антуан
Жомбор Пирош=Пирош Ж.,Пирош Жомбор
Ян Сатрал=Сатрал Я.,Сатрал Ян
Райан Руман=Руман Р.,Руман Райан
Синдзи Хазава=Хазава С.,Хазава Синдзи
Венсан Мийо=Мийо В.,Мийо Венсан
Джон Макнэлли=Макнэлли Д.,Макнэлли Джон
Майкл Ммо=Ммо М.,Ммо Майкл
Эрнан Касанова=Касанова Э.,Касанова Эрнан
Эдуард Эстеве Лобато=Эстеве Лобато Э.,Эстеве Лобато Эдуард
Ригеле Тэ=Тэ Р.,Тэ Ригеле
Александар Вукич=Вукич А.,Вукич Александар
Александр Шевченко=Шевченко А.,Шевченко Александр
Эван Чжу=Чжу Э.,Чжу Эван
Данила Калениченко=Калениченко Д.,Калениченко Данила
Аксель Хеллер=Хеллер А.,Хеллер Аксель
Жером Ким=Ким Ж.,Ким Жером
Илья Марченко=Марченко И.,Марченко Илья
Джордан Томпсон=Томпсон Д.,Томпсон Джордан
Титуан Дрог=Дрог Т.,Дрог Титуан
Александр Козбинов=Козбинов А.,Козбинов Александр
Ян Мертл=Мертл Я.,Мертл Ян
Янник Штайнеггер=Штайнеггер Я.,Штайнеггер Янник
Олег Приходько=Приходько О.,Приходько Олег
Юрий Джавакян=Джавакян Ю.,Джавакян Юрий
Андрей Голубев=Голубев А.,Голубев Андрей
Марсель Гранольерс=Гранольерс М.,Гранольерс Марсель
Арсение Златанович=Златанович А.,Златанович Арсение
Евгений Карловский=Карловский Е.,Карловский Евгений
Алессандро Петроне=Петроне А.,Петроне Алессандро
Роберто Кирос=Кирос Р.,Кирос Роберто
Марат Девятьяров=Девятьяров М.,Девятьяров Марат
Микаэль Имер=Имер М.,Имер Микаэль
Александер Эрлер=Эрлер А.,Эрлер Александер
Цзыхао Ся=Ся Ц.,Ся Цзыхао
Карен Хачанов=Хачанов К.,Хачанов Карен
Жо-Вильфрид Цонга=Цонга Ж.,Цонга Жо-Вильфрид
Душан Лайович=Лайович Д.,Лайович Душан
Милян Зекич=Зекич М.,Зекич Милян
Мэттью Мендес=Мендес М.,Мендес Мэттью
Кароль Джевецки=Джевецки К.,Джевецки Кароль
Маркос Каловелонис=Каловелонис М.,Каловелонис Маркос
Даниэль-Элаи Галан=Галан Д.,Галан Даниэль-Элаи
Суити Секигути=Секигути С.,Секигути Суити
Лоран Рошетт=Рошетт Л.,Рошетт Лоран
Александр Василенко=Василенко А.,Василенко Александр
Артур Казо=Казо А.,Казо Артур
Адам Павлашек=Павлашек А.,Павлашек Адам
Пабло Андухар=Андухар П.,Андухар Пабло
Праджнеш Гуннесваран=Гуннесваран П.,Гуннесваран Праджнеш
Эван Хойт=Хойт Э.,Хойт Эван
Марк-Андреа Хюслер=Хюслер М.,Хюслер Марк-Андреа
Роджер Федерер=Федерер Р.,Федерер Роджер
Уилл Спенсер=Спенсер У.,Спенсер Уилл
Гастау Элиаш=Элиаш Г.,Элиаш Гастау
Каспер Рууд=Рууд К.,Рууд Каспер
Алехандро Гомес=Гомес А.,Гомес Алехандро
Ник Хардт=Хардт Н.,Хардт Ник
Пауль Вёрнер=Вёрнер П.,Вёрнер Пауль
Хуан-Себастьян Гомес=Гомес Х.,Гомес Хуан-Себастьян
Кристиан Харрисон=Харрисон К.,Харрисон Кристиан
Алехандро Табило=Табило А.,Табило Алехандро
Кевин Кравиц=Кравиц К.,Кравиц Кевин
Андреа Пиккьоне=Пиккьоне А.,Пиккьоне Андреа
Даниэль Брандс=Брандс Д.,Брандс Даниэль
Джеймс Дакворт=Дакворт Д.,Дакворт Джеймс
Милош Раонич=Раонич М.,Раонич Милош
Леонардо Катани=Катани Л.,Катани Леонардо
Сумит Нагал=Нагал С.,Нагал Сумит
Энрике Луке Рико=Луке Рико Э.,Луке Рико Энрике
Даниэль Эванс=Эванс Д.,Эванс Даниэль
Давид Пихлер=Пихлер Д.,Пихлер Давид
Янник Ханфман=Ханфман Я.,Ханфман Янник
Федерико Дельбонис=Дельбонис Ф.,Дельбонис Федерико
Тай-Сон Квятковски=Квятковски Т.,Квятковски Тай-Сон
Николоз Басилашвили=Басилашвили Н.,Басилашвили Николоз
Поль Толедо-Баге=Толедо-Баге П.,Толедо-Баге Поль
Энди Маррей=Маррей Э.,Маррей Энди
Джеймс Уорд=Уорд Д.,Уорд Джеймс
Мате Валькус=Валькус М.,Валькус Мате
Энрико Далла Валле=Далла Валле Э.,Далла Валле Энрико
Томислав Бркич=Бркич Т.,Бркич Томислав
Дзюмпеи Ямасаки=Ямасаки Д.,Ямасаки Дзюмпеи
Дональд Янг=Янг Д.,Янг Дональд
Кэнто Такэути=Такэути К.,Такэути Кэнто
Рубен Бемельманс=Бемельманс Р.,Бемельманс Рубен
Педя Крстин=Крстин П.,Крстин Педя
Лодейвик Вестстрэйт=Вестстрэйт Л.,Вестстрэйт Лодейвик
Робин Хасе=Хасе Р.,Хасе Робин
Лилиан Мармус=Мармус Л.,Мармус Лилиан
Давид Вега-Эрнандес=Вега-Эрнандес Д.,Вега-Эрнандес Давид
Алдин Шеткич=Шеткич А.,Шеткич Алдин
Вальтер Трузенди=Трузенди В.,Трузенди Вальтер
Коллин Алтамирано=Алтамирано К.,Алтамирано Коллин
Петер Макк=Макк П.,Макк Петер
Гидо Андреосси=Андреосси Г.,Андреосси Гидо
Даниэль Ибрагимов=Ибрагимов Д.,Ибрагимов Даниэль
Хауме Пла Малфейто=Пла Малфейто Х.,Пла Малфейто Хауме
Андреа Вавассори=Вавассори А.,Вавассори Андреа
Лука Нарди=Нарди Л.,Нарди Лука
Кристофер О'Коннелл=О'Коннелл К.,О'Коннелл Кристофер
Алексей Попырин=Попырин А.,Попырин Алексей
Джи-Сун Нам=Нам Д.,Нам Джи-Сун
Ламин Уахаб=Уахаб Л.,Уахаб Ламин
Фелипе Мантилья=Мантилья Ф.,Мантилья Фелипе
Фабрицио Орнаго=Орнаго Ф.,Орнаго Фабрицио
Кириян Жаке=Жаке К.,Жаке Кириян
Джей Кларк=Кларк Д.,Кларк Джей
Джонатан Эйссерик=Эйссерик Д.,Эйссерик Джонатан
Пётр Бар-Бирюков=Бар-Бирюков П.,Бар-Бирюков Пётр
Жоао Лукас Реис Да Силва=Лукас Реис Да Силва Ж.,Лукас Реис Да Силва Жоао
Арно Бови=Бови А.,Бови Арно
Бастиан Тринкер=Тринкер Б.,Тринкер Бастиан
Хуан Пабло Варильяс Патино-Самудио=Пабло Варильяс Патино-Самудио Х.,Пабло Варильяс Патино-Самудио Хуан
Дмитрий Попко=Попко Д.,Попко Дмитрий
Федерико Гайо=Гайо Ф.,Гайо Федерико
Том Писане=Писане Т.,Писане Том
Флавио Коболли=Коболли Ф.,Коболли Флавио
Андреа Арнабольди=Арнабольди А.,Арнабольди Андреа
Томаш Махач=Махач Т.,Махач Томаш
Димитар Кузманов=Кузманов Д.,Кузманов Димитар
Саси Кумар Мукунд=Кумар Мукунд С.,Кумар Мукунд Саси
Иво Карлович=Карлович И.,Карлович Иво
Бенжамен Бонзи=Бонзи Б.,Бонзи Бенжамен
Петер Файта=Файта П.,Файта Петер
Джей-Си Арагон=Арагон Д.,Арагон Джей-Си
Глеб Сахаров=Сахаров Г.,Сахаров Глеб
Гидо Пелья=Пелья Г.,Пелья Гидо
Хироки Мория=Мория Х.,Мория Хироки
Себастьян Офнер=Офнер С.,Офнер Себастьян
Рудольф Моллекер=Моллекер Р.,Моллекер Рудольф
Харрисон Адамс=Адамс Х.,Адамс Харрисон
Азиз Дугаз=Дугаз А.,Дугаз Азиз
Йонас Тринкер=Тринкер Й.,Тринкер Йонас
Алекс Рыбаков=Рыбаков А.,Рыбаков Алекс
Маттео Мартино=Мартино М.,Мартино Маттео
Раду Албот=Албот Р.,Албот Раду
Хуан Пабло Фикович=Пабло Фикович Х.,Пабло Фикович Хуан
Кэмерон Грин=Грин К.,Грин Кэмерон
Йохан Никлес=Никлес Й.,Никлес Йохан
Лукас Лиллеенген=Лиллеенген Л.,Лиллеенген Лукас
Александр Мюллер=Мюллер А.,Мюллер Александр
Григор Димитров=Димитров Г.,Димитров Григор
Сандро Эра=Эра С.,Эра Сандро
Со Симабукуро=Симабукуро С.,Симабукуро Со
Такуто Ники=Ники Т.,Ники Такуто
Ренсо Оливо=Оливо Р.,Оливо Ренсо
Матс Розенкранц=Розенкранц М.,Розенкранц Матс
Эйдан Макхью=Макхью Э.,Макхью Эйдан
Аугуст Хольмгрен=Хольмгрен А.,Хольмгрен Аугуст
Сантьяго Фа Родригес Таверна=Фа Родригес Таверна С.,Фа Родригес Таверна Сантьяго
Чхун Хён=Хён Ч.,Хён Чхун
Джеффри-Джон Вулф=Вулф Д.,Вулф Джеффри-Джон
Николас Мехия=Мехия Н.,Мехия Николас
Карлос Алькарас Гарфия=Алькарас Гарфия К.,Алькарас Гарфия Карлос
Александр Ковачевич=Ковачевич А.,Ковачевич Александр
Йеспер Де Йонг=Де Йонг Й.,Де Йонг Йеспер
Эван Сонг=Сонг Э.,Сонг Эван
Николас Давид Ионел=Давид Ионел Н.,Давид Ионел Николас
Блаж Кавчич=Кавчич Б.,Кавчич Блаж
Маттео Виола=Виола М.,Виола Маттео
Михаил Кукушкин=Кукушкин М.,Кукушкин Михаил
Михал Конечны=Конечны М.,Конечны Михал
Даниэль Мазур=Мазур Д.,Мазур Даниэль
Гарол Майо=Майо Г.,Майо Гарол
Давид Гоффен=Гоффен Д.,Гоффен Давид
Максим Мора=Мора М.,Мора Максим
Марсело Аревало=Аревало М.,Аревало Марсело
Роберто Сид=Сид Р.,Сид Роберто
Денис Клок=Клок Д.,Клок Денис
Аттила Балаж=Балаж А.,Балаж Аттила
Тосихиде Мацуи=Мацуи Т.,Мацуи Тосихиде
Стив Дарси=Дарси С.,Дарси Стив
Павел Циас=Циас П.,Циас Павел
Жоау Олаво Соуза=Олаво Соуза Ж.,Олаво Соуза Жоау
Тьемо Де Баккер=Де Баккер Т.,Де Баккер Тьемо
Иван Эндара=Эндара И.,Эндара Иван
Роберто Маркора=Маркора Р.,Маркора Роберто
Роман Андрес Бурручага=Андрес Бурручага Р.,Андрес Бурручага Роман
Константин Шмитц=Шмитц К.,Шмитц Константин
Адриан Менендес-Масейрас=Менендес-Масейрас А.,Менендес-Масейрас Адриан
Фредерико-Феррейра Силва=Силва Ф.,Силва Фредерико-Феррейра
Уго Гренье=Гренье У.,Гренье Уго
Маркус Эрикссон=Эрикссон М.,Эрикссон Маркус
Мирча-Александру Жекан=Жекан М.,Жекан Мирча-Александру
Питер Кобелт=Кобелт П.,Кобелт Питер
Виталий Сачко=Сачко В.,Сачко Виталий
Ринки Хидзиката=Хидзиката Р.,Хидзиката Ринки
Педро Мартинес-Портеро=Мартинес-Портеро П.,Мартинес-Портеро Педро
Хуан Мануэль Серундоло=Мануэль Серундоло Х.,Мануэль Серундоло Хуан
Беньямин Хассан=Хассан Б.,Хассан Беньямин
Вишайя Тронгчаренчайкул=Тронгчаренчайкул В.,Тронгчаренчайкул Вишайя
Михаэл Врбенски=Врбенски М.,Врбенски Михаэл
Артюр Фил=Фил А.,Фил Артюр
Хосе Эрнандес-Фернандес=Эрнандес-Фернандес Х.,Эрнандес-Фернандес Хосе
Мариано Навоне=Навоне М.,Навоне Мариано
Ким Ён Сок=Ён Сок К.,Ён Сок Ким
Эчаргуи Моэз=Моэз Э.,Моэз Эчаргуи
Алессандро Джаннесси=Джаннесси А.,Джаннесси Алессандро
Ян Хоински=Хоински Я.,Хоински Ян
Фабьен Ребул=Ребул Ф.,Ребул Фабьен
Карлос Табернер=Табернер К.,Табернер Карлос
Адриан Оберт=Оберт А.,Оберт Адриан
Гун Маосинь=Маосинь Г.,Маосинь Гун
Гаэль Монфис=Монфис Г.,Монфис Гаэль
Синтаро Мочизуки=Мочизуки С.,Мочизуки Синтаро
Пол Мартин-Тиффон=Мартин-Тиффон П.,Мартин-Тиффон Пол
Артур Фери=Фери А.,Фери Артур
Дэн Аддед=Аддед Д.,Аддед Дэн
Луис Вессельс=Вессельс Л.,Вессельс Луис
Алексей Ватутин=Ватутин А.,Ватутин Алексей
Ариан Говеас=Говеас А.,Говеас Ариан
Фабио Фоньини=Фоньини Ф.,Фоньини Фабио
Адриен Боссель=Боссель А.,Боссель Адриен
Доминик Штефан Штрикер=Штефан Штрикер Д.,Штефан Штрикер Доминик
Альберт Алькарас-Иворра=Алькарас-Иворра А.,Алькарас-Иворра Альберт
Александар Лазов=Лазов А.,Лазов Александар
Джанни Мина=Мина Д.,Мина Джанни
Ким Чон Ий=Чон Ий К.,Чон Ий Ким
Филип Кристиан Джиану=Кристиан Джиану Ф.,Кристиан Джиану Филип
Маси Сарпола=Сарпола М.,Сарпола Маси
Максенс Бож=Бож М.,Бож Максенс
Петр Ноуза=Ноуза П.,Ноуза Петр
Фелипе Мелигени Родригес Альвес=Мелигени Родригес Альвес Ф.,Мелигени Родригес Альвес Фелипе
Баптист Крепатт=Крепатт Б.,Крепатт Баптист
Геральд Мельцер=Мельцер Г.,Мельцер Геральд
Максимильян Нойкрист=Нойкрист М.,Нойкрист Максимильян
Лоренцо Джустино=Джустино Л.,Джустино Лоренцо
Борна Гойо=Гойо Б.,Гойо Борна
Гао Синь=Синь Г.,Синь Гао
Матеус Пусинелли де Алмейда=Пусинелли де Алмейда М.,Пусинелли де Алмейда Матеус
Томас Фэнкатт=Фэнкатт Т.,Фэнкатт Томас
Баран Дженгиз=Дженгиз Б.,Дженгиз Баран
Ник Кирьос=Кирьос Н.,Кирьос Ник
Юсуке Такахаси=Такахаси Ю.,Такахаси Юсуке
Майк Урбания=Урбания М.,Урбания Майк
Лоренцо Сонего=Сонего Л.,Сонего Лоренцо
Стефано Травалья=Травалья С.,Травалья Стефано
Маттео Берреттини=Берреттини М.,Берреттини Маттео
Иржи Веселы=Веселы И.,Веселы Иржи
Томми Робредо=Робредо Т.,Робредо Томми
Мациэй Смола=Смола М.,Смола Мациэй
Денис Кудла=Кудла Д.,Кудла Денис
Паоло Лоренци=Лоренци П.,Лоренци Паоло
Ли Чжэ=Чжэ Л.,Чжэ Ли
Миомир Кецманович=Кецманович М.,Кецманович Миомир
Райан Харрисон=Харрисон Р.,Харрисон Райан
Роберто Ортега-Ольмедо=Ортега-Ольмедо Р.,Ортега-Ольмедо Роберто
Иржи Легечка=Легечка И.,Легечка Иржи
Ли Тук Хи=Тук Хи Л.,Тук Хи Ли
Мин-Киу Сонг=Сонг М.,Сонг Мин-Киу
Симоне Ронкалли=Ронкалли С.,Ронкалли Симоне
Джаред Доналдсон=Доналдсон Д.,Доналдсон Джаред
Хуан-Мартин дель Потро=дель Потро Х.,дель Потро Хуан-Мартин
Оливер Кроуфорд=Кроуфорд О.,Кроуфорд Оливер
Томас Лоран=Лоран Т.,Лоран Томас
Илья Снитари=Снитари И.,Снитари Илья
Мартин Клижан=Клижан М.,Клижан Мартин
Кристофер Хейман=Хейман К.,Хейман Кристофер
Федерико Себальос=Себальос Ф.,Себальос Федерико
Энзо Куако=Куако Э.,Куако Энзо
Хон Сон Чан=Сон Чан Х.,Сон Чан Хон
Киган Смит=Смит К.,Смит Киган
Амин Ахуда=Ахуда А.,Ахуда Амин
Марин Чилич=Чилич М.,Чилич Марин
Петер Торебко=Торебко П.,Торебко Петер
Алан Коэн=Коэн А.,Коэн Алан
Николо Инсерра=Инсерра Н.,Инсерра Николо
Седрик-Марсель Штебе=Штебе С.,Штебе Седрик-Марсель
Марко Мичели=Мичели М.,Мичели Марко
Гонсало Эскобар=Эскобар Г.,Эскобар Гонсало
Матия Пецотич=Пецотич М.,Пецотич Матия
Даниэль Михальски=Михальски Д.,Михальски Даниэль
Люк Савилл=Савилл Л.,Савилл Люк
Джейкоб Гриллс=Гриллс Д.,Гриллс Джейкоб
Новак Джокович=Джокович Н.,Джокович Новак
Мартин Куэвас=Куэвас М.,Куэвас Мартин
Наоки Тадзима=Тадзима Н.,Тадзима Наоки
Карл Кьюр Саар=Кьюр Саар К.,Кьюр Саар Карл
Константин Кравчук=Кравчук К.,Кравчук Константин
Так-Хунн Ван=Ван Т.,Ван Так-Хунн
Гийс Броувер=Броувер Г.,Броувер Гийс
Ежи Янович=Янович Е.,Янович Ежи
Лоренцо Музетти=Музетти Л.,Музетти Лоренцо
Майкл Шабаз=Шабаз М.,Шабаз Майкл
Уилсон Лайте=Лайте У.,Лайте Уилсон
Алексис Мусьялек=Мусьялек А.,Мусьялек Алексис
Ишай Олиэль=Олиэль И.,Олиэль Ишай
Филип Пеливо=Пеливо Ф.,Пеливо Филип
Джек Дрэйпер=Дрэйпер Д.,Дрэйпер Джек
Патрик Кипсон=Кипсон П.,Кипсон Патрик
У Ибин=Ибин У.,Ибин У
Эллис Блэйк=Блэйк Э.,Блэйк Эллис
Стивен Диез=Диез С.,Диез Стивен
Квон Сон У=Сон У К.,Сон У Квон
Риккардо Бонадьо=Бонадьо Р.,Бонадьо Риккардо
Алек Адамсон=Адамсон А.,Адамсон Алек
Александр Недовесов=Недовесов А.,Недовесов Александр
Лука Ванни=Ванни Л.,Ванни Лука
Егор Герасимов=Герасимов Е.,Герасимов Егор
Райлли Опелка=Опелка Р.,Опелка Райлли
Джереми Бил=Бил Д.,Бил Джереми
Улисс Бланч=Бланч У.,Бланч Улисс
Данте Дженнаро=Дженнаро Д.,Дженнаро Данте
Йонаш Форейтек=Форейтек Й.,Форейтек Йонаш
Хавьер Марти=Марти Х.,Марти Хавьер
Алафия Айени=Айени А.,Айени Алафия
Дэниел Нгуйен=Нгуйен Д.,Нгуйен Дэниел
Корентен Муте=Муте К.,Муте Корентен
Жюль Окала=Окала Ж.,Окала Жюль
Драгош Дима=Дима Д.,Дима Драгош
Теннис Сандгрен=Сандгрен Т.,Сандгрен Теннис
Давид Перес-Санс=Перес-Санс Д.,Перес-Санс Давид
Тим Пюц=Пюц Т.,Пюц Тим
Андрей Чепелев=Чепелев А.,Чепелев Андрей
Лу Яньсюнь=Яньсюнь Л.,Яньсюнь Лу
Лукас Мугевичюс=Мугевичюс Л.,Мугевичюс Лукас
Янник Синнер=Синнер Я.,Синнер Янник
Владислав Орлов=Орлов В.,Орлов Владислав
Хосе Франсиско Видаль Асорин=Франсиско Видаль Асорин Х.,Франсиско Видаль Асорин Хосе
Брейден Шнур=Шнур Б.,Шнур Брейден
Павел Щая-Зубров=Щая-Зубров П.,Щая-Зубров Павел
Янко Типсаревич=Типсаревич Я.,Типсаревич Янко
Домагой Бильешко=Бильешко Д.,Бильешко Домагой
Самуэль Бенсуссан=Бенсуссан С.,Бенсуссан Самуэль
Юго Гастон=Гастон Ю.,Гастон Юго
Александр Метревели=Метревели А.,Метревели Александр
Джэйсон Каблер=Каблер Д.,Каблер Джэйсон
Александр Зверев=Зверев А.,Зверев Александр
Луис Патино=Патино Л.,Патино Луис
Себастьян Баэс=Баэс С.,Баэс Себастьян
Ян Бондаревский=Бондаревский Я.,Бондаревский Ян
Фабиан Марожан=Марожан Ф.,Марожан Фабиан
Дуе Айдукович=Айдукович Д.,Айдукович Дуе
Факундо Багнис=Багнис Ф.,Багнис Факундо
Нерман Фатич=Фатич Н.,Фатич Нерман
Римпей Каваками=Каваками Р.,Каваками Римпей
Франсиско Серундоло=Серундоло Ф.,Серундоло Франсиско
Том Фоусетт=Фоусетт Т.,Фоусетт Том
Стефано Баттальино=Баттальино С.,Баттальино Стефано
Имаи Синтаро=Синтаро И.,Синтаро Имаи
Саймон Карр=Карр С.,Карр Саймон
Таро Дэниэл=Дэниэл Т.,Дэниэл Таро
Ален Авидзба=Авидзба А.,Авидзба Ален
Роберто Баутиста-Агут=Баутиста-Агут Р.,Баутиста-Агут Роберто
Мануэль Пенья Лопес=Пенья Лопес М.,Пенья Лопес Мануэль
Лассе Мушайтис=Мушайтис Л.,Мушайтис Лассе
Даниэль Альтмайер=Альтмайер Д.,Альтмайер Даниэль
Франческо Пассаро=Пассаро Ф.,Пассаро Франческо
Ясутака Утияма=Утияма Я.,Утияма Ясутака
Эллиот Беншетри=Беншетри Э.,Беншетри Эллиот
Тим ван Рейтховен=ван Рейтховен Т.,ван Рейтховен Тим
Франческо Форти=Форти Ф.,Форти Франческо
Питер Бертран=Бертран П.,Бертран Питер
Валентин Роер=Роер В.,Роер Валентин
Александр Игошин=Игошин А.,Игошин Александр
Педро Качин=Качин П.,Качин Педро
Мик Лескюр=Лескюр М.,Лескюр Мик
Богдан Бобров=Бобров Б.,Бобров Богдан
Матеус Алвес=Алвес М.,Алвес Матеус
Артём Смирнов=Смирнов А.,Смирнов Артём
Ярослав Поспишил=Поспишил Я.,Поспишил Ярослав
Джейсон Джунг=Джунг Д.,Джунг Джейсон
Бастьян Малья=Малья Б.,Малья Бастьян
Митчелл Крюгер=Крюгер М.,Крюгер Митчелл
Эльмар Эюпович=Эюпович Э.,Эюпович Эльмар
Иван Гахов=Гахов И.,Гахов Иван
Эрнесто Эскобедо=Эскобедо Э.,Эскобедо Эрнесто
Савриян Данилов=Данилов С.,Данилов Савриян
Лука Гельхардт=Гельхардт Л.,Гельхардт Лука
Сандер Арендс=Арендс С.,Арендс Сандер
Элиот Спиццирри=Спиццирри Э.,Спиццирри Элиот
Жюльен Каньина=Каньина Ж.,Каньина Жюльен
Грегуар Баррер=Баррер Г.,Баррер Грегуар
Диего Идальго=Идальго Д.,Идальго Диего
Стэн Вавринка=Вавринка С.,Вавринка Стэн
Адриан Маннарино=Маннарино А.,Маннарино Адриан
Роберто Карбальес-Баэна=Карбальес-Баэна Р.,Карбальес-Баэна Роберто
Аластер Грей=Грей А.,Грей Аластер
Акира Сантиллан=Сантиллан А.,Сантиллан Акира
Рента Токуда=Токуда Р.,Токуда Рента
Шериф Сабри=Сабри Ш.,Сабри Шериф
Алекс Болт=Болт А.,Болт Алекс
Кацпер Жук=Жук К.,Жук Кацпер
Микаэль Гертс=Гертс М.,Гертс Микаэль
Даниил Глинка=Глинка Д.,Глинка Даниил
Генаро Альберто Оливьери=Альберто Оливьери Г.,Альберто Оливьери Генаро
Денис Истомин=Истомин Д.,Истомин Денис
Тимофей Скатов=Скатов Т.,Скатов Тимофей
Федерико Арнабольди=Арнабольди Ф.,Арнабольди Федерико
Клеман Генс=Генс К.,Генс Клеман
Рой Смит=Смит Р.,Смит Рой
Деян Катич=Катич Д.,Катич Деян
Азиз Кияметович=Кияметович А.,Кияметович Азиз
Маттео Донати=Донати М.,Донати Маттео
Борна Чорич=Чорич Б.,Чорич Борна
Серхио Гутьеррес-Ферроль=Гутьеррес-Ферроль С.,Гутьеррес-Ферроль Серхио
Анте Павич=Павич А.,Павич Анте
Деннис Новак=Новак Д.,Новак Деннис
Ботик ван де Зандсхулп=ван де Зандсхулп Б.,ван де Зандсхулп Ботик
Кей Нисикори=Нисикори К.,Нисикори Кей
Пьер-Юг Эрбер=Эрбер П.,Эрбер Пьер-Юг
Гарри Буркьер=Буркьер Г.,Буркьер Гарри
Бьорн Фрэтэнджело=Фрэтэнджело Б.,Фрэтэнджело Бьорн
Макото Оти=Оти М.,Оти Макото
Томас Липовсек-Пучес=Липовсек-Пучес Т.,Липовсек-Пучес Томас
Марко Чеккинато=Чеккинато М.,Чеккинато Марко
Спритви Сехар=Сехар С.,Сехар Спритви
Марк Полманс=Полманс М.,Полманс Марк
Александер Ричард=Ричард А.,Ричард Александер
Патрик Рикль=Рикль П.,Рикль Патрик
Скандер Мансури=Мансури С.,Мансури Скандер
Максим Жанвье=Жанвье М.,Жанвье Максим
Тацума Ито=Ито Т.,Ито Тацума
Фелисьяно Лопес=Лопес Ф.,Лопес Фелисьяно
Тобиас Камке=Камке Т.,Камке Тобиас
Фредерику Жил=Жил Ф.,Жил Фредерику
Мануэль Гинар=Гинар М.,Гинар Мануэль
Ээро Васа=Васа Э.,Васа Ээро
Михал Дембек=Дембек М.,Дембек Михал
Петр Михнев=Михнев П.,Михнев Петр
Дэйн Келли=Келли Д.,Келли Дэйн
Евгений Тюрнев=Тюрнев Е.,Тюрнев Евгений
Матей Сабанов=Сабанов М.,Сабанов Матей
Факундо Мена=Мена Ф.,Мена Факундо
Кристиан Линделл=Линделл К.,Линделл Кристиан
Реми Бертола=Бертола Р.,Бертола Реми
Томми Пол=Пол Т.,Пол Томми
Джанлука Маджер=Маджер Д.,Маджер Джанлука
Алексей Крутых=Крутых А.,Крутых Алексей
Ласло Джере=Джере Л.,Джере Ласло
Ник Чеппелл=Чеппелл Н.,Чеппелл Ник
Франко Агаменоне=Агаменоне Ф.,Агаменоне Франко
Камиль Майхшак=Майхшак К.,Майхшак Камиль
Виктор Джурашович=Джурашович В.,Джурашович Виктор
Маттео Арнальди=Арнальди М.,Арнальди Маттео
Хуан-Баутиста Торрес=Торрес Х.,Торрес Хуан-Баутиста
Гонсалу Оливейра=Оливейра Г.,Оливейра Гонсалу
Йосихито Нисиока=Нисиока Й.,Нисиока Йосихито
Андреа Пеллегрино=Пеллегрино А.,Пеллегрино Андреа
Максим Кресси=Кресси М.,Кресси Максим
Эмилио Нава=Нава Э.,Нава Эмилио
Жоау Домингеш=Домингеш Ж.,Домингеш Жоау
Илья Ивашко=Ивашко И.,Ивашко Илья
Ноа Рубин=Рубин Н.,Рубин Ноа
Николас Альварес Варона=Альварес Варона Н.,Альварес Варона Николас
Тимо Легу=Легу Т.,Легу Тимо
Сайдало Сайдкаримов=Сайдкаримов С.,Сайдкаримов Сайдало
Бернабе Сапата-Миральес=Сапата-Миральес Б.,Сапата-Миральес Бернабе
Марко Топо=Топо М.,Топо Марко
Стефан Козлов=Козлов С.,Козлов Стефан
Лиам Броэди=Броэди Л.,Броэди Лиам
Даниэль Химено-Травер=Химено-Травер Д.,Химено-Травер Даниэль
Юки Мотизуки=Мотизуки Ю.,Мотизуки Юки
Никола Чачич=Чачич Н.,Чачич Никола
Нино Сердарушич=Сердарушич Н.,Сердарушич Нино
Давиде Галоппини=Галоппини Д.,Галоппини Давиде
Эрги Киркин=Киркин Э.,Киркин Эрги
Павел Неедлы=Неедлы П.,Неедлы Павел
Александр Бублик=Бублик А.,Бублик Александр
Мориц Тим=Тим М.,Тим Мориц
Бен Патаэл=Патаэл Б.,Патаэл Бен
Ник Разборшек=Разборшек Н.,Разборшек Ник
Дарко Боянович=Боянович Д.,Боянович Дарко
Садьо Думбия=Думбия С.,Думбия Садьо
Джованни Мпетчи Перрикар=Мпетчи Перрикар Д.,Мпетчи Перрикар Джованни
Тьяго Агустин Тиранте=Агустин Тиранте Т.,Агустин Тиранте Тьяго
Лука Джакомини=Джакомини Л.,Джакомини Лука
Кевин Андерсон=Андерсон К.,Андерсон Кевин
Норберт Гомбош=Гомбош Н.,Гомбош Норберт
Джон-Патрик Смит=Смит Д.,Смит Джон-Патрик
Дамир Джумхур=Джумхур Д.,Джумхур Дамир
Тайлер Зинк=Зинк Т.,Зинк Тайлер
Сунь Фацзин=Фацзин С.,Фацзин Сунь
Джек Минджи Лин=Минджи Лин Д.,Минджи Лин Джек
Янник Рётер=Рётер Я.,Рётер Янник
Карлос Гомес-Эррера=Гомес-Эррера К.,Гомес-Эррера Карлос
Джорди Арконада=Арконада Д.,Арконада Джорди
Рафаэл Матос=Матос Р.,Матос Рафаэл
Жоао Педро Соржи=Педро Соржи Ж.,Педро Соржи Жоао
Мариус Рузгас=Рузгас М.,Рузгас Мариус
Алехандро Давидович-Фокина=Давидович-Фокина А.,Давидович-Фокина Алехандро
Кэмерон Норри=Норри К.,Норри Кэмерон
Янн Марти=Марти Я.,Марти Янн
Марвин Нетушил=Нетушил М.,Нетушил Марвин
Вит Коприва=Коприва В.,Коприва Вит
Андрей Кузнецов=Кузнецов А.,Кузнецов Андрей
Харри Хелиоваара=Хелиоваара Х.,Хелиоваара Харри
Филип Горански=Горански Ф.,Горански Филип
Йосуке Ватануки=Ватануки Й.,Ватануки Йосуке
Николас Санчес-Искьердо=Санчес-Искьердо Н.,Санчес-Искьердо Николас
Оскар Отте=Отте О.,Отте Оскар
Иньиго Сервантес=Сервантес И.,Сервантес Иньиго
Хумаюн Султанов=Султанов Х.,Султанов Хумаюн
Натаниэль Ламмонс=Ламмонс Н.,Ламмонс Натаниэль
Хуан-Игнасио Галарса=Галарса Х.,Галарса Хуан-Игнасио
Чен Сун Ло=Сун Ло Ч.,Сун Ло Чен
Янис Подзус=Подзус Я.,Подзус Янис
Аксель Гарсиян=Гарсиян А.,Гарсиян Аксель
Мануэль Санчес=Санчес М.,Санчес Мануэль
Пабло Алемани=Алемани П.,Алемани Пабло
Феликс Оже-Альяссим=Оже-Альяссим Ф.,Оже-Альяссим Феликс
Янник Жанковиц=Жанковиц Я.,Жанковиц Янник
Брайдан Кляйн=Кляйн Б.,Кляйн Брайдан
Ришар Гаске=Гаске Р.,Гаске Ришар
Юки Бхамбри=Бхамбри Ю.,Бхамбри Юки
Кентен Алис=Алис К.,Алис Кентен
Петер Хеллер=Хеллер П.,Хеллер Петер
Бернард Томич=Томич Б.,Томич Бернард
Нуну Боргес=Боргес Н.,Боргес Нуну
Михаил Перволаракис=Перволаракис М.,Перволаракис Михаил
Юлиан Оклеппо=Оклеппо Ю.,Оклеппо Юлиан
Марио Вилелья-Мартинес=Вилелья-Мартинес М.,Вилелья-Мартинес Марио
Кальвен Эмери=Эмери К.,Эмери Кальвен
Омар Джакалоне=Джакалоне О.,Джакалоне Омар
Хэ Екон=Екон Х.,Екон Хэ
Йозеф Ковалик=Ковалик Й.,Ковалик Йозеф
Макс Пёрселл=Пёрселл М.,Пёрселл Макс
Теймураз Габашвили=Габашвили Т.,Габашвили Теймураз
Тимур Киямов=Киямов Т.,Киямов Тимур
Генри Лааксонен=Лааксонен Г.,Лааксонен Генри
Диего Шварцман=Шварцман Д.,Шварцман Диего
Адриан Бодмер=Бодмер А.,Бодмер Адриан
Нам Хоан Лю=Хоан Лю Н.,Хоан Лю Нам
Сантьяго Хиральдо=Хиральдо С.,Хиральдо Сантьяго
Марек Генгель=Генгель М.,Генгель Марек
Джанлуиджи Квинци=Квинци Д.,Квинци Джанлуиджи
Матвей Минин=Минин М.,Минин Матвей
Клеман Табур=Табур К.,Табур Клеман
Далибор Сврчина=Сврчина Д.,Сврчина Далибор
Патрик Никлас-Салминен=Никлас-Салминен П.,Никлас-Салминен Патрик
Арджун Кадхе=Кадхе А.,Кадхе Арджун
Александр Журбин=Журбин А.,Журбин Александр
Чэнь Ти=Ти Ч.,Ти Чэнь
Зденек Коларж=Коларж З.,Коларж Зденек
Игор Смилански=Смилански И.,Смилански Игор
Жозе Перейра=Перейра Ж.,Перейра Жозе
Николас Баррьентос=Баррьентос Н.,Баррьентос Николас
Драгос Никола Мадарас=Никола Мадарас Д.,Никола Мадарас Драгос
Алексис Галарно=Галарно А.,Галарно Алексис
Марко Бортолотти=Бортолотти М.,Бортолотти Марко
Петер Надь=Надь П.,Надь Петер
Маккензи Макдональд=Макдональд М.,Макдональд Маккензи
Джон Миллман=Миллман Д.,Миллман Джон
Зейн Хан=Хан З.,Хан Зейн
Николае Фрунза=Фрунза Н.,Фрунза Николае
Уго Дельен=Дельен У.,Дельен Уго
Говинд Нанда=Нанда Г.,Нанда Говинд
Симоне Болелли=Болелли С.,Болелли Симоне
Майкл Редлики=Редлики М.,Редлики Майкл
Алехандро Гонсалес=Гонсалес А.,Гонсалес Алехандро
Филип Мисолич=Мисолич Ф.,Мисолич Филип
Марко Тепавац=Тепавац М.,Тепавац Марко
Эдан Лешем=Лешем Э.,Лешем Эдан
Лоренцо Фриджерио=Фриджерио Л.,Фриджерио Лоренцо
Факундо Диас Акоста=Диас Акоста Ф.,Диас Акоста Факундо
Спенсер Папа=Папа С.,Папа Спенсер
Джек Сок=Сок Д.,Сок Джек
Блэйк Мотт=Мотт Б.,Мотт Блэйк
Хуберт Хуркач=Хуркач Х.,Хуркач Хуберт,ГУРКАЧ Х.,Хуркач Х
Гонсало Фалькао=Фалькао Г.,Фалькао Гонсало
Егор Носкин=Носкин Е.,Носкин Егор
Стив Джонсон=Джонсон С.,Джонсон Стив
Янник Ванденбульке=Ванденбульке Я.,Ванденбульке Янник
Карл Сёдерлунд=Сёдерлунд К.,Сёдерлунд Карл
Мариуш Копил=Копил М.,Копил Мариуш
Павел Вербин=Вербин П.,Вербин Павел
Гонсало Лама=Лама Г.,Лама Гонсало
Иван Давыдов=Давыдов И.,Давыдов Иван
Ян-Леннард Штруфф=Штруфф Я.,Штруфф Ян-Леннард
Алессандро Бега=Бега А.,Бега Алессандро
Джесс Уиттен=Уиттен Д.,Уиттен Джесс
Эн Виджай Сундар Прашант=Виджай Сундар Прашант Э.,Виджай Сундар Прашант Эн
Бенджамин Лок=Лок Б.,Лок Бенджамин
Пабло Виверо-Гонсалес=Виверо-Гонсалес П.,Виверо-Гонсалес Пабло
Тим Смычек=Смычек Т.,Смычек Тим
Педро Сакамото=Сакамото П.,Сакамото Педро
Себастьян Фанселёв=Фанселёв С.,Фанселёв Себастьян
Киммер Коппеянс=Коппеянс К.,Коппеянс Киммер
Малек Жазири=Жазири М.,Жазири Малек
Эндрю Полсон=Полсон Э.,Полсон Эндрю
Ван Чухань=Чухань В.,Чухань Ван
Петрос Хрисохос=Хрисохос П.,Хрисохос Петрос
Деннис Новиков=Новиков Д.,Новиков Деннис
Андре Гаспар-Мурта=Гаспар-Мурта А.,Гаспар-Мурта Андре
Кристьян Гарин=Гарин К.,Гарин Кристьян
Сэм Куэрри=Куэрри С.,Куэрри Сэм
Сандро Копп=Копп С.,Копп Сандро
Антон Чехов=Чехов А.,Чехов Антон
Антуан Хон=Хон А.,Хон Антуан
Алексис Готье=Готье А.,Готье Алексис
Стронг Киркхаймер=Киркхаймер С.,Киркхаймер Стронг
Адриан Андреев=Андреев А.,Андреев Адриан
Пабло Куэвас=Куэвас П.,Куэвас Пабло
Элиас Имер=Имер Э.,Имер Элиас
Гонсало Вильянуэва=Вильянуэва Г.,Вильянуэва Гонсало
Пол Остербан=Остербан П.,Остербан Пол
Ондржей Крстев=Крстев О.,Крстев Ондржей
Каруэ Селл=Селл К.,Селл Каруэ
Жоау Монтейру=Монтейру Ж.,Монтейру Жоау
Брэдли Мусли=Мусли Б.,Мусли Брэдли
Реймонд Сармиенто=Сармиенто Р.,Сармиенто Реймонд
Бруно Кузухара=Кузухара Б.,Кузухара Бруно
Лукас Катарина=Катарина Л.,Катарина Лукас
Юлиан Ленц=Ленц Ю.,Ленц Юлиан
Кевин Кинг=Кинг К.,Кинг Кевин
Аслан Карацев=Карацев А.,Карацев Аслан
Кайл Эдмунд=Эдмунд К.,Эдмунд Кайл
Матс Мораинг=Мораинг М.,Мораинг Матс
Юрген Мельцер=Мельцер Ю.,Мельцер Юрген
Янник Мертенс=Мертенс Я.,Мертенс Янник
Жоффрей Бланкано=Бланкано Ж.,Бланкано Жоффрей
Александр Саркисян=Саркисян А.,Саркисян Александр
Марсело Томас Барриос Вера=Томас Барриос Вера М.,Томас Барриос Вера Марсело
Антон Матусевич=Матусевич А.,Матусевич Антон
Том Кочевар-Дешман=Кочевар-Дешман Т.,Кочевар-Дешман Том
Габриэле Мария Ноче=Мария Ноче Г.,Мария Ноче Габриэле
Фрэнсис Тиафо=Тиафо Ф.,Тиафо Фрэнсис
Неманья Малесевич=Малесевич Н.,Малесевич Неманья
Жоан-Себастьен Татло=Татло Ж.,Татло Жоан-Себастьен
Артём Дубривный=Дубривный А.,Дубривный Артём
Вацлав Шафранек=Шафранек В.,Шафранек Вацлав
Алехо-Лоренсо Лингуа-Лавальен=Лингуа-Лавальен А.,Лингуа-Лавальен Алехо-Лоренсо
Антуан Эскоффье=Эскоффье А.,Эскоффье Антуан
Томас Фаббьяно=Фаббьяно Т.,Фаббьяно Томас
Хуан-Пабло Пас=Пас Х.,Пас Хуан-Пабло
Брэндон Накашима=Накашима Б.,Накашима Брэндон
Констан Летьен=Летьен К.,Летьен Констан
Мартин Редлики=Редлики М.,Редлики Мартин
Руан Рулофсе=Рулофсе Р.,Рулофсе Руан
Миколай Лоренс=Лоренс М.,Лоренс Миколай
Алекс Молчан=Молчан А.,Молчан Алекс
Любомир Целебич=Целебич Л.,Целебич Любомир
Карлос Химено Валеро=Химено Валеро К.,Химено Валеро Карлос
Джон Иснер=Иснер Д.,Иснер Джон
Хольгер Витус Нёсков Руне=Витус Нёсков Руне Х.,Витус Нёсков Руне Хольгер
У Ди=Ди У.,Ди У
Марсель Илхан=Илхан М.,Илхан Марсель
Максим Аму=Аму М.,Аму Максим
Иван Сергеев=Сергеев И.,Сергеев Иван
Чжан Чжичжэнь=Чжичжэнь Ч.,Чжичжэнь Чжан
Хорди Сампер-Монтана=Сампер-Монтана Х.,Сампер-Монтана Хорди
Ленни Хампель=Хампель Л.,Хампель Ленни
Мохамед Сафват=Сафват М.,Сафват Мохамед
Дэйн Суини=Суини Д.,Суини Дэйн
Сэм Тэйлор=Тэйлор С.,Тэйлор Сэм
Лукаш Лацко=Лацко Л.,Лацко Лукаш
Петру-Александру Лункану=Лункану П.,Лункану Петру-Александру
Хират Навасирисомбоон=Навасирисомбоон Х.,Навасирисомбоон Хират
Юрий Родионов=Родионов Ю.,Родионов Юрий
Юн Сён Чхун=Сён Чхун Ю.,Сён Чхун Юн
Виктор Троицки=Троицки В.,Троицки Виктор
Клаудио Фортуна=Фортуна К.,Фортуна Клаудио
Даниэль Муньос-де ла Нава=Муньос-де ла Нава Д.,Муньос-де ла Нава Даниэль
Захари Свайда=Свайда З.,Свайда Захари
Карлис Озолиньш=Озолиньш К.,Озолиньш Карлис
Танаси Коккинакис=Коккинакис Т.,Коккинакис Танаси
Трент Брайд=Брайд Т.,Брайд Трент
Тьяго Уайлд=Уайлд Т.,Уайлд Тьяго
Маттиас Бахингер=Бахингер М.,Бахингер Маттиас
Тигре Анк=Анк Т.,Анк Тигре
Джонатан Мрида=Мрида Д.,Мрида Джонатан
Доминик Бёлер=Бёлер Д.,Бёлер Доминик
Томас Мартин Этчеверри=Мартин Этчеверри Т.,Мартин Этчеверри Томас
Марко Трунгеллити=Трунгеллити М.,Трунгеллити Марко
Кристофер Юбэнкс=Юбэнкс К.,Юбэнкс Кристофер
Эдоардо Еремин=Еремин Э.,Еремин Эдоардо
Мирза Башич=Башич М.,Башич Мирза
Бенуа Пэр=Пэр Б.,Пэр Бенуа
Филиппо Бальди=Бальди Ф.,Бальди Филиппо
Хорхе Брайан Панта Эррерос=Брайан Панта Эррерос Х.,Брайан Панта Эррерос Хорхе
Франсиско Кабраль=Кабраль Ф.,Кабраль Франсиско
Артур Риндеркнеш=Риндеркнеш А.,Риндеркнеш Артур
Зура Ткемаладзе=Ткемаладзе З.,Ткемаладзе Зура
Александре Бакши=Бакши А.,Бакши Александре
Матиас Франко Дескотте=Франко Дескотте М.,Франко Дескотте Матиас
Луиш Фария=Фария Л.,Фария Луиш
Карим-Мохамед Маамун=Маамун К.,Маамун Карим-Мохамед
Эдуардо Струвай=Струвай Э.,Струвай Эдуардо
Сергей Фомин=Фомин С.,Фомин Сергей
Конор Берг=Берг К.,Берг Конор
Владимир Иванов=Иванов В.,Иванов Владимир
Юта Симидзу=Симидзу Ю.,Симидзу Юта
Колин Синклэйр=Синклэйр К.,Синклэйр Колин
Джаред Хильцик=Хильцик Д.,Хильцик Джаред
Оскар Жозе Гутьеррез=Жозе Гутьеррез О.,Жозе Гутьеррез Оскар
Сальваторе Карузо=Карузо С.,Карузо Сальваторе
Люк Джонсон=Джонсон Л.,Джонсон Люк
Павел Крайник=Крайник П.,Крайник Павел
Франко Ронкаделли=Ронкаделли Ф.,Ронкаделли Франко
Томас Беллуччи=Беллуччи Т.,Беллуччи Томас
Тьягу Какау=Какау Т.,Какау Тьягу
Ориоль Рока-Баталья=Рока-Баталья О.,Рока-Баталья Ориоль
Секу Бангура=Бангура С.,Бангура Секу
Матиас Бург=Бург М.,Бург Матиас
Игор Сейслинг=Сейслинг И.,Сейслинг Игор
Стефано Наполитано=Наполитано С.,Наполитано Стефано
Алибек Качмазов=Качмазов А.,Качмазов Алибек
Джулиан Кэш=Кэш Д.,Кэш Джулиан
Рикардо Охеда-Лара=Охеда-Лара Р.,Охеда-Лара Рикардо
Антонин Штепанек=Штепанек А.,Штепанек Антонин
Кентен Робер=Робер К.,Робер Кентен
Жиль Симон=Симон Ж.,Симон Жиль
Петер Голдштайнер=Голдштайнер П.,Голдштайнер Петер
Паскаль Майс=Майс П.,Майс Паскаль
Филип Краинович=Краинович Ф.,Краинович Филип
Лукас Ноймайер=Ноймайер Л.,Ноймайер Лукас
Максим Шазаль=Шазаль М.,Шазаль Максим
Доминик Тим=Тим Д.,Тим Доминик
Юго Нис=Нис Ю.,Нис Юго
Петрос Циципас=Циципас П.,Циципас Петрос
Доминик Кёпфер=Кёпфер Д.,Кёпфер Доминик
Александр Бинда=Бинда А.,Бинда Александр
Аристарх Сафонов=Сафонов А.,Сафонов Аристарх
Эрик Ваншельбойм=Ваншельбойм Э.,Ваншельбойм Эрик
Габриэль Алехандро Идальго=Алехандро Идальго Г.,Алехандро Идальго Габриэль
Мартон Фучович=Фучович М.,Фучович Мартон
Хамад Меджедович=Меджедович Х.,Меджедович Хамад
Жоау Соуза=Соуза Ж.,Соуза Жоау
Мэверик Бейнс=Бейнс М.,Бейнс Мэверик
Лукаш Клейн=Клейн Л.,Клейн Лукаш
Янки Эрел=Эрел Я.,Эрел Янки
Маркос Гирон=Гирон М.,Гирон Маркос
Филипп Кольшрайбер=Кольшрайбер Ф.,Кольшрайбер Филипп
Николас Морено-Де-Альборан=Морено-Де-Альборан Н.,Морено-Де-Альборан Николас
Константин Жжёнов=Жжёнов К.,Жжёнов Константин
Жордан Коррея Пассос До Кармо=Коррея Пассос До Кармо Ж.,Коррея Пассос До Кармо Жордан
Рожериу Дутра да Силва=Дутра да Силва Р.,Дутра да Силва Рожериу
Николас Джарри=Джарри Н.,Джарри Николас
Рафаэль Надаль=Надаль Р.,Надаль Рафаэль
Александр Павлюченков=Павлюченков А.,Павлюченков Александр
Андреа Бассо=Бассо А.,Бассо Андреа
Даниэль Цукерман=Цукерман Д.,Цукерман Даниэль
Ллойд Гласспул=Гласспул Л.,Гласспул Ллойд
Лукаш Росол=Росол Л.,Росол Лукаш
Орландо Лус=Лус О.,Лус Орландо
Кай Венельт=Венельт К.,Венельт Кай
Леандро Риди=Риди Л.,Риди Леандро
Маттия Беллуччи=Беллуччи М.,Беллуччи Маттия
Нильс Лотсма=Лотсма Н.,Лотсма Нильс
Себастьян Корда=Корда С.,Корда Себастьян
Якопо Берреттини=Берреттини Я.,Берреттини Якопо
Тайсэй Итикава=Итикава Т.,Итикава Тайсэй
Ченг-Ю Ю=Ю Ч.,Ю Ченг-Ю
Рамкумар Раманатан=Раманатан Р.,Раманатан Рамкумар
Сэм Риффис=Риффис С.,Риффис Сэм
Алексей Захаров=Захаров А.,Захаров Алексей
Лукас Гомес=Гомес Л.,Гомес Лукас
Николас Альварес=Альварес Н.,Альварес Николас
Кеннет Райсма=Райсма К.,Райсма Кеннет
Роман Сафиуллин=Сафиуллин Р.,Сафиуллин Роман
Дуди Села=Села Д.,Села Дуди
Лауринас Григелис=Григелис Л.,Григелис Лауринас
Финн Тирни=Тирни Ф.,Тирни Финн
Андреа Кольярини=Кольярини А.,Кольярини Андреа
Пабло Карреньо-Буста=Карреньо-Буста П.,Карреньо-Буста Пабло
Йереми Ян=Ян Й.,Ян Йереми
Кальман Бойд=Бойд К.,Бойд Кальман
Жоао Лукас Магальяэс Хуэб Де Менезес=Лукас Магальяэс Хуэб Де Менезес Ж.,Лукас Магальяэс Хуэб Де Менезес Жоао
Рэй Хо=Хо Р.,Хо Рэй
Василь Кирков=Кирков В.,Кирков Василь
Эмиль Руусувуори=Руусувуори Э.,Руусувуори Эмиль
Никола Милоевич=Милоевич Н.,Милоевич Никола
Павел Котов=Котов П.,Котов Павел
Ю Сиу Сю=Сиу Сю Ю.,Сиу Сю Ю
Карлос Болуда-Пуркисс=Болуда-Пуркисс К.,Болуда-Пуркисс Карлос
На Чон Вон=Чон Вон Н.,Чон Вон На
Люка Пуллан=Пуллан Л.,Пуллан Люка
Даниил Медведев=Медведев Д.,Медведев Даниил
Артур де Греф=де Греф А.,де Греф Артур
Камило Уго Карабельи=Уго Карабельи К.,Уго Карабельи Камило
Андрес Артунедо-Мартинаварро=Артунедо-Мартинаварро А.,Артунедо-Мартинаварро Андрес
Ричардас Беранкис=Беранкис Р.,Беранкис Ричардас
Тьяго Монтейро=Монтейро Т.,Монтейро Тьяго
Дуе Кекез=Кекез Д.,Кекез Дуе
Отто Виртанен=Виртанен О.,Виртанен Отто
Владислав Манафов=Манафов В.,Манафов Владислав
Дженсон Бруксби=Бруксби Д.,Бруксби Дженсон
Маурисио Эчасу=Эчасу М.,Эчасу Маурисио
Лени Митьяна=Митьяна Л.,Митьяна Лени
Таканьи Гаранганга=Гаранганга Т.,Гаранганга Таканьи
Тристан Ламасин=Ламасин Т.,Ламасин Тристан
Гейдж Браймер=Браймер Г.,Браймер Гейдж
Артурс Лаздиньш=Лаздиньш А.,Лаздиньш Артурс
Хазем Нав=Нав Х.,Нав Хазем
Карлос Санчес-Ховер=Санчес-Ховер К.,Санчес-Ховер Карлос
Войцех Марек=Марек В.,Марек Войцех
Алехандро Моро Канас=Моро Канас А.,Моро Канас Алехандро
Агустин Велотти=Велотти А.,Велотти Агустин
Тобиас Зимон=Зимон Т.,Зимон Тобиас
Алтуг Джеликбилек=Джеликбилек А.,Джеликбилек Алтуг
Тристан Скулкейт=Скулкейт Т.,Скулкейт Тристан
Егор Агафонов=Агафонов Е.,Агафонов Егор
Блаж Рола=Рола Б.,Рола Блаж
Александар Лазаров=Лазаров А.,Лазаров Александар
Михаил Коровин=Коровин М.,Коровин Михаил
Робин Станек=Станек Р.,Станек Робин
Василе Антонеску=Антонеску В.,Антонеску Василе
Мариано Кестельбоим=Кестельбоим М.,Кестельбоим Мариано
Бруно Сант'Анна=Сант'Анна Б.,Сант'Анна Бруно
Франческо Вилардо=Вилардо Ф.,Вилардо Франческо
Зизу Бергс=Бергс З.,Бергс Зизу
Карл Фриберг=Фриберг К.,Фриберг Карл
Жилберт Соарес Клиер=Соарес Клиер Ж.,Соарес Клиер Жилберт
Санджар Файзиев=Файзиев С.,Файзиев Санджар
Уго Умбер=Умбер У.,Умбер Уго
Аляж Бедене=Бедене А.,Бедене Аляж
Эрик Крепальди=Крепальди Э.,Крепальди Эрик
Брендон Холт=Холт Б.,Холт Брендон
Даниэль Ринкон=Ринкон Д.,Ринкон Даниэль
Микаэль Торпегор=Торпегор М.,Торпегор Микаэль
Томас Фархат=Фархат Т.,Фархат Томас
Альберт Рамос-Виньолас=Рамос-Виньолас А.,Рамос-Виньолас Альберт
Пьетро Рондони=Рондони П.,Рондони Пьетро
Николя Маю=Маю Н.,Маю Николя
Себастьен Больц=Больц С.,Больц Себастьен
Альбано Оливетти=Оливетти А.,Оливетти Альбано
Данило Петрович=Петрович Д.,Петрович Данило
Янник Маден=Маден Я.,Маден Янник
Том Жомби=Жомби Т.,Жомби Том
Педру Соуза=Соуза П.,Соуза Педру
Ву Тун-Лин=Тун-Лин В.,Тун-Лин Ву
Джованни Фонио=Фонио Д.,Фонио Джованни
Йелле Селс=Селс Й.,Селс Йелле
Александр Крнокрак=Крнокрак А.,Крнокрак Александр
Джулио Цеппьери=Цеппьери Д.,Цеппьери Джулио
Шимон Вальков=Вальков Ш.,Вальков Шимон
Эндрю Харрис=Харрис Э.,Харрис Эндрю
Юрген Зопп=Зопп Ю.,Зопп Юрген
Антонио Массара=Массара А.,Массара Антонио
Жереми Шарди=Шарди Ж.,Шарди Жереми
Иманол Лопес Морильо=Лопес Морильо И.,Лопес Морильо Иманол
Никола Кун=Кун Н.,Кун Никола
Марвин Мёллер=Мёллер М.,Мёллер Марвин
Йоганнес Гертайс=Гертайс Й.,Гертайс Йоганнес
Дариан Кинг=Кинг Д.,Кинг Дариан
Хантер Риз=Риз Х.,Риз Хантер
Тимур Хабибулин=Хабибулин Т.,Хабибулин Тимур
Эван Кинг=Кинг Э.,Кинг Эван
Дамиен Венгер=Венгер Д.,Венгер Дамиен
Иван Неделько=Неделько И.,Неделько Иван
Петер Гоёвчик=Гоёвчик П.,Гоёвчик Петер
Го Соеда=Соеда Г.,Соеда Го
Джем Илькель=Илькель Д.,Илькель Джем
Федерико Кория=Кория Ф.,Кория Федерико
Тадас Бабелис=Бабелис Т.,Бабелис Тадас
Матьё Першико=Першико М.,Першико Матьё
Эмилио Гомес=Гомес Э.,Гомес Эмилио
Артюр Реймон=Реймон А.,Реймон Артюр
Рауль Бранкаччо=Бранкаччо Р.,Бранкаччо Рауль
Андрей Рублёв=Рублёв А.,Рублёв Андрей
Денис Шаповалов=Шаповалов Д.,Шаповалов Денис
Эван Фурнесс=Фурнесс Э.,Фурнесс Эван
Сидхарт Рават=Рават С.,Рават Сидхарт
Тоби Алекс Кодат=Алекс Кодат Т.,Алекс Кодат Тоби
Жерон Ваннест=Ваннест Ж.,Ваннест Жерон
Вашек Поспишил=Поспишил В.,Поспишил Вашек
Сора Факунда=Факунда С.,Факунда Сора
Андрей Мартин=Мартин А.,Мартин Андрей
Николас Киккер=Киккер Н.,Киккер Николас
Сергей Стаховский=Стаховский С.,Стаховский Сергей
Мэттью Эбден=Эбден М.,Эбден Мэттью
Виктор Галович=Галович В.,Галович Виктор
